daynum,pid,activity_number,activity_type,start_time,end_time,duration,lid
0,0,0,1,0,15300,15300,671
0,0,2,2,15900,46500,30600,429
0,0,4,4,47460,48180,720,413
0,0,6,2,49140,57600,8460,429
0,0,8,1,58500,100800,42300,671
1,0,9,1,100800,187200,86400,671
2,0,10,1,187200,273600,86400,671
3,0,11,1,273600,360000,86400,671
4,0,12,1,360000,405900,45900,671
4,0,14,4,407100,407400,300,337
4,0,16,3,408000,412260,4260,97
4,0,18,1,413520,446400,32880,671
5,0,19,2,446400,457200,10800,429
5,0,21,1,458100,505800,47700,671
5,0,23,2,506700,532800,26100,429
6,0,24,1,532800,555300,22500,671
6,0,26,7,555600,561600,6000,90
6,0,28,3,561900,562200,300,170
6,0,30,1,562500,604800,42300,671
0,1,0,1,0,22800,22800,708
0,1,2,2,24300,55800,31500,396
0,1,4,1,57600,100800,43200,708
1,1,5,1,100800,114480,13680,708
1,1,7,2,116760,131280,14520,396
1,1,9,4,132300,135720,3420,483
1,1,11,2,136080,150180,14100,396
1,1,13,1,152340,187200,34860,708
2,1,14,1,187200,200880,13680,708
2,1,16,2,203160,217680,14520,396
2,1,18,4,218700,222120,3420,603
2,1,20,2,222480,236580,14100,396
2,1,22,1,238740,273600,34860,708
3,1,23,1,273600,287280,13680,708
3,1,25,2,289560,304080,14520,396
3,1,27,4,305100,308520,3420,365
3,1,29,2,308880,322980,14100,396
3,1,31,1,325140,360000,34860,708
4,1,32,1,360000,384600,24600,708
4,1,34,4,386100,387900,1800,337
4,1,36,3,388320,391920,3600,60
4,1,38,4,392400,393720,1320,416
4,1,40,4,394500,395040,540,630
4,1,42,4,395820,396900,1080,606
4,1,44,1,397260,446400,49140,708
5,1,45,1,446400,475200,28800,708
5,1,47,3,476100,477000,900,249
5,1,49,1,477900,532800,54900,708
6,1,50,2,532800,567000,34200,396
6,1,52,2,568800,577800,9000,396
6,1,54,1,579000,604800,25800,708
0,2,0,1,0,28800,28800,636
0,2,2,6,30600,41400,10800,260
0,2,4,1,43200,50400,7200,636
0,2,6,4,51300,57600,6300,587
0,2,8,1,58500,64800,6300,636
0,2,10,3,64980,65700,720,25
0,2,12,1,65880,100800,34920,636
1,2,13,1,100800,115200,14400,636
1,2,15,1,117300,127800,10500,636
1,2,17,6,129000,134400,5400,260
1,2,19,1,135600,137700,2100,636
1,2,21,1,140160,148500,8340,636
1,2,23,4,149400,156600,7200,385
1,2,25,1,157800,187200,29400,636
2,2,26,1,187200,201600,14400,636
2,2,28,1,203700,214200,10500,636
2,2,30,6,215400,220800,5400,260
2,2,32,1,222000,224100,2100,636
2,2,34,1,226560,234900,8340,636
2,2,36,4,235800,243000,7200,620
2,2,38,1,244200,273600,29400,636
3,2,39,1,273600,288000,14400,636
3,2,41,1,290100,300600,10500,636
3,2,43,6,301800,307200,5400,260
3,2,45,1,308400,310500,2100,636
3,2,47,1,312960,321300,8340,636
3,2,49,4,322200,329400,7200,574
3,2,51,1,330600,360000,29400,636
4,2,52,4,360000,446400,86400,620
5,2,53,1,446400,466200,19800,636
5,2,55,3,467100,473400,6300,166
5,2,57,3,474000,480120,6120,172
5,2,59,4,481680,482880,1200,455
5,2,61,1,484500,532800,48300,636
6,2,62,1,532800,563400,30600,636
6,2,64,4,564600,564900,300,513
6,2,66,4,565860,585660,19800,390
6,2,68,1,587760,604800,17040,636
0,3,0,1,0,55800,55800,677
0,3,2,5,55980,75600,19620,269
0,3,4,1,75840,100800,24960,677
1,3,5,1,100800,117900,17100,677
1,3,7,5,118800,138780,19980,269
1,3,9,1,139440,187200,47760,677
2,3,10,1,187200,204300,17100,677
2,3,12,5,205200,225180,19980,269
2,3,14,1,225840,273600,47760,677
3,3,15,1,273600,290700,17100,677
3,3,17,5,291600,311580,19980,269
3,3,19,1,312240,360000,47760,677
4,3,20,1,360000,395400,35400,677
4,3,22,4,395820,396900,1080,612
4,3,24,4,397020,397500,480,554
4,3,26,4,397920,399300,1380,481
4,3,28,1,399900,446400,46500,677
5,3,29,1,446400,464400,18000,677
5,3,31,4,475200,478800,3600,363
5,3,33,4,479100,532800,53700,334
6,3,34,1,532800,549000,16200,677
6,3,36,7,549900,557700,7800,204
6,3,38,1,558660,568500,9840,677
6,3,40,4,569220,579300,10080,371
6,3,42,1,581460,604800,23340,677
0,4,0,1,0,26400,26400,714
0,4,2,5,26700,52200,25500,268
0,4,4,1,52500,100800,48300,714
1,4,5,1,100800,114000,13200,714
1,4,7,4,114120,114480,360,491
1,4,9,5,115200,147900,32700,268
1,4,11,1,148500,187200,38700,714
2,4,12,1,187200,200400,13200,714
2,4,14,4,200520,200880,360,507
2,4,16,5,201600,234300,32700,268
2,4,18,1,234900,273600,38700,714
3,4,19,1,273600,286800,13200,714
3,4,21,4,286920,287280,360,282
3,4,23,5,288000,320700,32700,268
3,4,25,1,321300,360000,38700,714
4,4,26,1,360000,370800,10800,714
4,4,28,5,371700,398100,26400,268
4,4,30,4,398400,403200,4800,291
4,4,32,1,404400,408300,3900,714
4,4,34,4,408900,411300,2400,628
4,4,36,4,411600,421200,9600,425
4,4,38,1,422400,446400,24000,714
5,4,39,1,446400,468000,21600,714
5,4,41,3,468600,472800,4200,122
5,4,43,1,473100,477000,3900,714
5,4,45,4,477300,477900,600,609
5,4,47,4,478860,502200,23340,489
5,4,49,4,504540,505800,1260,476
5,4,51,1,506700,507600,900,714
5,4,53,1,509400,532800,23400,714
6,4,54,1,532800,555300,22500,714
6,4,56,7,555600,561600,6000,115
6,4,58,3,561900,562200,300,21
6,4,60,1,562500,604800,42300,714
0,5,0,1,0,22680,22680,683
0,5,2,2,23400,59340,35940,271
0,5,4,4,60000,62940,2940,365
0,5,6,1,64260,100800,36540,683
1,5,7,1,100800,111900,11100,683
1,5,9,2,113400,157800,44400,271
1,5,11,3,159300,160500,1200,134
1,5,13,1,161100,187200,26100,683
2,5,14,1,187200,198300,11100,683
2,5,16,2,199800,244200,44400,271
2,5,18,3,245700,246900,1200,134
2,5,20,1,247500,273600,26100,683
3,5,21,1,273600,284700,11100,683
3,5,23,2,286200,330600,44400,271
3,5,25,3,332100,333300,1200,147
3,5,27,1,333900,360000,26100,683
4,5,28,1,360000,362700,2700,683
4,5,30,4,364500,369000,4500,414
4,5,32,4,383100,384300,1200,627
4,5,34,2,396900,399600,2700,271
4,5,36,4,399900,403200,3300,610
4,5,38,2,403500,414000,10500,271
4,5,40,4,414300,417600,3300,631
4,5,42,4,417900,437400,19500,443
5,5,44,1,438600,446400,7800,683
5,5,45,1,446400,469800,23400,683
5,5,47,4,470700,471000,300,584
5,5,49,4,471600,472260,660,279
5,5,51,4,472620,473400,780,458
5,5,53,4,474900,479400,4500,618
5,5,55,4,479880,487800,7920,291
5,5,57,1,488880,497400,8520,683
5,5,59,4,498000,502800,4800,455
5,5,61,1,503400,532800,29400,683
6,5,62,1,532800,544500,11700,683
6,5,64,7,545700,574200,28500,190
6,5,66,7,576000,582900,6900,190
6,5,68,1,583800,604800,21000,683
0,6,0,1,0,56340,56340,642
0,6,2,4,58560,58860,300,524
0,6,4,2,60420,77460,17040,267
0,6,6,1,79140,100800,21660,642
1,6,7,1,100800,111000,10200,642
1,6,9,2,113100,142200,29100,267
1,6,11,1,143100,187200,44100,642
2,6,12,1,187200,197400,10200,642
2,6,14,2,199500,228600,29100,267
2,6,16,1,229500,273600,44100,642
3,6,17,1,273600,283800,10200,642
3,6,19,2,285900,315000,29100,267
3,6,21,1,315900,360000,44100,642
4,6,22,1,360000,446400,86400,642
5,6,23,1,446400,459600,13200,642
5,6,25,4,460080,460440,360,614
5,6,27,3,460920,463200,2280,51
5,6,29,4,464100,466800,2700,568
5,6,31,1,467700,492300,24600,642
5,6,33,4,493500,501600,8100,631
5,6,35,4,502500,503400,900,631
5,6,37,1,504300,532800,28500,642
6,6,38,1,532800,537900,5100,642
6,6,40,2,538500,557970,19470,267
6,6,42,2,558090,560700,2610,267
6,6,44,2,561000,582600,21600,267
6,6,46,1,583500,604800,21300,642
0,7,0,1,0,18000,18000,692
0,7,2,4,21600,100800,79200,540
1,7,3,1,100800,136800,36000,692
1,7,5,3,137700,140100,2400,38
1,7,7,3,140400,142200,1800,187
1,7,9,1,143100,152100,9000,692
1,7,11,3,153000,153900,900,98
1,7,13,3,155100,156600,1500,3
1,7,15,1,156900,187200,30300,692
2,7,16,1,187200,223200,36000,692
2,7,18,3,224100,226500,2400,253
2,7,20,3,226800,228600,1800,162
2,7,22,1,229500,238500,9000,692
2,7,24,3,239400,240300,900,168
2,7,26,3,241500,243000,1500,233
2,7,28,1,243300,273600,30300,692
3,7,29,1,273600,309600,36000,692
3,7,31,3,310500,312900,2400,69
3,7,33,3,313200,315000,1800,111
3,7,35,1,315900,324900,9000,692
3,7,37,3,325800,326700,900,12
3,7,39,3,327900,329400,1500,229
3,7,41,1,329700,360000,30300,692
4,7,42,1,360000,381600,21600,692
4,7,44,4,382800,386700,3900,294
4,7,46,3,387000,387360,360,120
4,7,48,3,387900,389700,1800,136
4,7,50,1,390900,446400,55500,692
5,7,51,1,446400,461400,15000,692
5,7,53,4,462000,462600,600,568
5,7,55,2,462900,484200,21300,337
5,7,57,2,486900,492300,5400,337
5,7,59,1,494400,502200,7800,692
5,7,61,4,502500,503400,900,322
5,7,63,1,504000,532800,28800,692
6,7,64,1,532800,551700,18900,692
6,7,66,4,552300,552600,300,587
6,7,68,4,554400,565200,10800,595
6,7,70,4,566400,568800,2400,383
6,7,72,3,569700,572580,2880,68
6,7,74,4,572700,573000,300,419
6,7,76,4,574800,579600,4800,559
6,7,78,4,580500,584100,3600,322
6,7,80,3,587100,588900,1800,247
6,7,82,1,589800,604800,15000,692
0,8,0,1,0,42960,42960,733
0,8,2,4,43800,45900,2100,412
0,8,4,3,46500,46800,300,212
0,8,6,1,47100,100800,53700,733
1,8,7,1,100800,187200,86400,733
2,8,8,1,187200,273600,86400,733
3,8,9,1,273600,360000,86400,733
4,8,10,1,360000,396240,36240,733
4,8,12,3,397500,400200,2700,111
4,8,14,4,400500,400860,360,343
4,8,16,4,400980,401280,300,610
4,8,18,3,401760,403680,1920,179
4,8,20,1,403920,446400,42480,733
5,8,21,1,446400,473400,27000,733
5,8,23,3,474000,475800,1800,150
5,8,25,3,477000,477900,900,36
5,8,27,1,478800,532800,54000,733
6,8,28,1,532800,549900,17100,733
6,8,30,2,552600,559200,6600,300
6,8,32,3,560400,562500,2100,84
6,8,34,3,562800,566100,3300,43
6,8,36,1,567000,604800,37800,733
0,9,0,1,0,30600,30600,638
0,9,2,4,31560,32100,540,366
0,9,4,4,41640,42300,660,555
0,9,6,4,56160,100800,44640,322
1,9,7,1,100800,111240,10440,638
1,9,9,2,112980,145920,32940,379
1,9,11,4,146400,150300,3900,633
1,9,13,1,152100,156600,4500,638
1,9,15,4,157500,187200,29700,368
2,9,16,1,187200,197640,10440,638
2,9,18,2,199380,232320,32940,379
2,9,20,4,232800,236700,3900,419
2,9,22,1,238500,243000,4500,638
2,9,24,4,243900,273600,29700,344
3,9,25,1,273600,284040,10440,638
3,9,27,2,285780,318720,32940,379
3,9,29,4,319200,323100,3900,355
3,9,31,1,324900,329400,4500,638
3,9,33,4,330300,360000,29700,455
4,9,34,1,360000,379800,19800,638
4,9,36,4,380700,387900,7200,291
4,9,38,1,388800,390600,1800,638
4,9,40,2,391200,391500,300,379
4,9,42,1,391800,446400,54600,638
5,9,43,1,446400,474300,27900,638
5,9,45,2,475500,508500,33000,379
5,9,47,3,509100,509700,600,45
5,9,49,1,511200,532800,21600,638
6,9,50,1,532800,556800,24000,638
6,9,52,7,558000,561900,3900,205
6,9,54,4,562800,566100,3300,585
6,9,56,1,566400,579600,13200,638
6,9,58,4,579840,582720,2880,618
6,9,60,1,582900,604800,21900,638
0,10,0,1,0,32400,32400,698
0,10,2,4,32700,33000,300,504
0,10,4,4,34800,36000,1200,366
0,10,6,3,36300,36600,300,53
0,10,8,4,38400,43380,4980,496
0,10,10,1,43980,100800,56820,698
1,10,11,1,100800,115200,14400,698
1,10,13,2,117900,147600,29700,343
1,10,15,4,150240,150540,300,400
1,10,17,1,150900,187200,36300,698
2,10,18,1,187200,201600,14400,698
2,10,20,2,204300,234000,29700,343
2,10,22,4,236640,236940,300,591
2,10,24,1,237300,273600,36300,698
3,10,25,1,273600,288000,14400,698
3,10,27,2,290700,320400,29700,343
3,10,29,4,323040,323340,300,455
3,10,31,1,323700,360000,36300,698
4,10,32,4,360000,446400,86400,365
5,10,33,1,446400,467100,20700,698
5,10,35,4,468000,476100,8100,494
5,10,37,4,477000,482400,5400,415
5,10,39,4,483300,483600,300,348
5,10,41,7,484800,487800,3000,194
5,10,43,3,488280,489300,1020,151
5,10,45,1,490440,532800,42360,698
6,10,46,1,532800,543600,10800,698
6,10,48,1,546900,550500,3600,698
6,10,50,7,550800,562200,11400,194
6,10,52,1,562500,604800,42300,698
0,11,0,1,0,39600,39600,682
0,11,2,1,46200,100800,54600,682
1,11,3,1,100800,187200,86400,682
2,11,4,1,187200,273600,86400,682
3,11,5,1,273600,360000,86400,682
4,11,6,1,360000,382800,22800,682
4,11,8,3,383400,385200,1800,53
4,11,10,1,386220,446400,60180,682
5,11,11,1,446400,532800,86400,682
6,11,12,1,532800,556200,23400,682
6,11,14,7,556800,567000,10200,144
6,11,16,4,567600,568200,600,333
6,11,18,1,568800,604800,36000,682
0,12,0,1,0,25800,25800,720
0,12,2,5,26760,57000,30240,262
0,12,4,1,57900,62100,4200,720
0,12,6,4,63300,100800,37500,607
1,12,7,1,100800,129600,28800,720
1,12,9,4,130200,131400,1200,587
1,12,11,4,133200,144000,10800,600
1,12,13,1,145800,153000,7200,720
1,12,15,1,155040,187200,32160,720
2,12,16,1,187200,216000,28800,720
2,12,18,4,216600,217800,1200,361
2,12,20,4,219600,230400,10800,365
2,12,22,1,232200,239400,7200,720
2,12,24,1,241440,273600,32160,720
3,12,25,1,273600,302400,28800,720
3,12,27,4,303000,304200,1200,615
3,12,29,4,306000,316800,10800,385
3,12,31,1,318600,325800,7200,720
3,12,33,1,327840,360000,32160,720
4,12,34,1,360000,385200,25200,720
4,12,36,4,386100,387000,900,276
4,12,38,4,387600,388800,1200,365
4,12,40,3,389700,392400,2700,83
4,12,42,3,393300,394200,900,155
4,12,44,4,394500,394800,300,414
4,12,46,4,395100,396000,900,615
4,12,48,1,396900,403200,6300,720
4,12,50,4,404100,408600,4500,587
4,12,52,4,409500,411300,1800,572
4,12,54,1,412200,446400,34200,720
5,12,55,1,446400,488100,41700,720
5,12,57,1,491100,532800,41700,720
6,12,58,1,532800,562200,29400,720
6,12,60,3,563400,577200,13800,256
6,12,62,1,578700,604800,26100,720
0,13,0,1,0,25020,25020,659
0,13,2,5,25440,57600,32160,272
0,13,4,1,57840,100800,42960,659
1,13,5,1,100800,127800,27000,659
1,13,7,4,128220,132540,4320,586
1,13,9,4,133200,133500,300,587
1,13,11,1,133620,187200,53580,659
2,13,12,1,187200,214200,27000,659
2,13,14,4,214620,218940,4320,618
2,13,16,4,219600,219900,300,615
2,13,18,1,220020,273600,53580,659
3,13,19,1,273600,300600,27000,659
3,13,21,4,301020,305340,4320,563
3,13,23,4,306000,306300,300,363
3,13,25,1,306420,360000,53580,659
4,13,26,1,360000,373500,13500,659
4,13,28,5,374400,403200,28800,272
4,13,30,1,404400,446400,42000,659
5,13,31,1,446400,482400,36000,659
5,13,33,5,482700,516600,33900,272
5,13,35,1,516900,532800,15900,659
6,13,36,1,532800,572400,39600,659
6,13,38,4,573000,576000,3000,368
6,13,40,1,576600,577800,1200,659
6,13,42,4,578100,595200,17100,282
6,13,44,1,595800,604800,9000,659
0,14,0,1,0,44400,44400,652
0,14,2,1,44640,54000,9360,652
0,14,4,3,55200,56700,1500,239
0,14,6,4,57600,64800,7200,548
0,14,8,4,65700,66600,900,610
0,14,10,1,67500,100800,33300,652
1,14,11,1,100800,126300,25500,652
1,14,13,4,127500,165900,38400,306
1,14,15,1,167400,187200,19800,652
2,14,16,1,187200,212700,25500,652
2,14,18,4,213900,252300,38400,334
2,14,20,1,253800,273600,19800,652
3,14,21,1,273600,299100,25500,652
3,14,23,4,300300,338700,38400,286
3,14,25,1,340200,360000,19800,652
4,14,26,1,360000,380700,20700,652
4,14,28,4,382080,386700,4620,613
4,14,30,4,387420,391680,4260,487
4,14,32,4,393120,407880,14760,392
4,14,34,1,409440,446400,36960,652
5,14,35,4,446400,465000,18600,294
5,14,37,3,465300,468180,2880,119
5,14,39,4,468300,469020,720,612
5,14,41,4,469560,472620,3060,623
5,14,43,3,473160,484200,11040,113
5,14,45,1,486060,495900,9840,652
5,14,47,4,496800,502200,5400,320
5,14,49,1,503100,532800,29700,652
6,14,50,1,532800,604800,72000,652
0,15,0,1,0,26400,26400,648
0,15,2,5,27300,55080,27780,272
0,15,4,4,55560,57600,2040,366
0,15,6,3,58500,59400,900,134
0,15,8,1,60300,100800,40500,648
1,15,9,1,100800,114300,13500,648
1,15,11,5,114600,142200,27600,272
1,15,13,4,144000,151200,7200,365
1,15,15,1,153000,187200,34200,648
2,15,16,1,187200,200700,13500,648
2,15,18,5,201000,228600,27600,272
2,15,20,4,230400,237600,7200,486
2,15,22,1,239400,273600,34200,648
3,15,23,1,273600,287100,13500,648
3,15,25,5,287400,315000,27600,272
3,15,27,4,316800,324000,7200,415
3,15,29,1,325800,360000,34200,648
4,15,30,1,360000,376200,16200,648
4,15,32,5,376800,400200,23400,272
4,15,34,1,401400,408300,6900,648
4,15,36,4,410880,413280,2400,362
4,15,38,4,414900,420300,5400,568
4,15,40,1,421200,446400,25200,648
5,15,41,1,446400,465900,19500,648
5,15,43,3,466320,467760,1440,59
5,15,45,3,468720,473280,4560,67
5,15,47,4,475080,489780,14700,618
5,15,49,1,491880,532800,40920,648
6,15,50,1,532800,550800,18000,648
6,15,52,7,552000,567600,15600,203
6,15,54,1,568800,604800,36000,648
0,16,0,1,0,14400,14400,684
0,16,2,4,14520,23220,8700,530
0,16,4,1,30600,45540,14940,684
0,16,6,4,46020,48840,2820,568
0,16,8,1,49200,60180,10980,684
0,16,10,3,60780,61140,360,142
0,16,12,1,61680,100800,39120,684
1,16,13,1,100800,113400,12600,684
1,16,15,2,115200,149400,34200,261
1,16,17,1,152100,187200,35100,684
2,16,18,1,187200,199800,12600,684
2,16,20,2,201600,235800,34200,261
2,16,22,1,238500,273600,35100,684
3,16,23,1,273600,286200,12600,684
3,16,25,2,288000,322200,34200,261
3,16,27,1,324900,360000,35100,684
4,16,28,1,360000,369600,9600,684
4,16,30,2,371700,403200,31500,261
4,16,32,4,405000,406800,1800,570
4,16,34,4,408600,413100,4500,368
4,16,36,3,414000,416700,2700,27
4,16,38,1,417600,446400,28800,684
5,16,39,1,446400,488640,42240,684
5,16,41,4,489120,495240,6120,491
5,16,43,1,495840,501000,5160,684
5,16,45,4,502140,507240,5100,609
5,16,47,1,508560,532800,24240,684
6,16,48,1,532800,556200,23400,684
6,16,50,4,557100,574200,17100,291
6,16,52,4,575100,576000,900,348
6,16,54,3,576600,579000,2400,35
6,16,56,1,580800,604800,24000,684
0,17,0,4,0,14400,14400,376
0,17,2,1,14520,23400,8880,689
0,17,4,2,24300,40200,15900,271
0,17,6,2,40800,44100,3300,271
0,17,8,2,45000,55800,10800,271
0,17,10,4,57300,59100,1800,348
0,17,12,4,60300,61800,1500,455
0,17,14,1,62400,100800,38400,689
1,17,15,2,100800,114300,13500,271
1,17,17,1,115500,135600,20100,689
1,17,19,3,135780,136080,300,166
1,17,21,1,136380,146400,10020,689
1,17,23,4,146700,147000,300,572
1,17,25,1,147300,153900,6600,689
1,17,27,4,154500,158400,3900,573
1,17,29,1,159000,187200,28200,689
2,17,30,2,187200,200700,13500,271
2,17,32,1,201900,222000,20100,689
2,17,34,3,222180,222480,300,7
2,17,36,1,222780,232800,10020,689
2,17,38,4,233100,233400,300,467
2,17,40,1,233700,240300,6600,689
2,17,42,4,240900,244800,3900,568
2,17,44,1,245400,273600,28200,689
3,17,45,2,273600,287100,13500,271
3,17,47,1,288300,308400,20100,689
3,17,49,3,308580,308880,300,88
3,17,51,1,309180,319200,10020,689
3,17,53,4,319500,319800,300,491
3,17,55,1,320100,326700,6600,689
3,17,57,4,327300,331200,3900,501
3,17,59,1,331800,360000,28200,689
4,17,60,1,360000,375420,15420,689
4,17,62,2,376200,390000,13800,271
4,17,64,1,390420,391320,900,689
4,17,66,2,391800,412740,20940,271
4,17,68,1,413520,417240,3720,689
4,17,70,3,417780,418500,720,227
4,17,72,1,418980,446400,27420,689
5,17,73,1,446400,464400,18000,689
5,17,75,4,465600,469200,3600,517
5,17,77,3,469800,472800,3000,236
5,17,79,1,473640,492600,18960,689
5,17,81,4,494700,503400,8700,365
5,17,83,1,504300,532800,28500,689
6,17,84,4,532800,554400,21600,455
6,17,86,4,557400,604800,47400,466
0,18,0,1,0,25440,25440,675
0,18,2,2,27720,65580,37860,501
0,18,4,4,67740,68700,960,415
0,18,6,4,69300,69600,300,415
0,18,8,3,69780,70200,420,143
0,18,10,4,70350,70650,300,587
0,18,12,1,71220,100800,29580,675
1,18,13,1,100800,114900,14100,675
1,18,15,2,115140,150180,35040,501
1,18,17,1,150360,187200,36840,675
2,18,18,1,187200,201300,14100,675
2,18,20,2,201540,236580,35040,501
2,18,22,1,236760,273600,36840,675
3,18,23,1,273600,287700,14100,675
3,18,25,2,287940,322980,35040,501
3,18,27,1,323160,360000,36840,675
4,18,28,1,360000,362700,2700,675
4,18,30,2,364500,401400,36900,501
4,18,32,1,404400,446400,42000,675
5,18,33,1,446400,462600,16200,675
5,18,35,4,463200,463800,600,308
5,18,37,1,465000,467400,2400,675
5,18,39,4,467640,468720,1080,415
5,18,41,1,468960,478800,9840,675
5,18,43,4,479400,480480,1080,365
5,18,45,1,481320,484500,3180,675
5,18,47,3,485040,486600,1560,111
5,18,49,4,486900,488520,1620,587
5,18,51,1,489060,532800,43740,675
6,18,52,1,532800,548400,15600,675
6,18,54,3,549000,549600,600,128
6,18,56,1,549900,553500,3600,675
6,18,58,3,553800,554100,300,67
6,18,60,1,554400,570600,16200,675
6,18,62,3,571200,571500,300,162
6,18,64,3,572100,575220,3120,49
6,18,66,3,575700,576600,900,108
6,18,68,1,577800,604800,27000,675
0,19,0,1,0,28980,28980,680
0,19,2,4,29760,30060,300,549
0,19,4,5,30900,57300,26400,264
0,19,6,4,57930,58230,300,383
0,19,8,4,58620,61500,2880,415
0,19,10,3,61860,62160,300,206
0,19,12,1,62460,100800,38340,680
1,19,13,1,100800,113700,12900,680
1,19,15,5,114900,140400,25500,264
1,19,17,1,141900,187200,45300,680
2,19,18,1,187200,200100,12900,680
2,19,20,5,201300,226800,25500,264
2,19,22,1,228300,273600,45300,680
3,19,23,1,273600,286500,12900,680
3,19,25,5,287700,313200,25500,264
3,19,27,1,314700,360000,45300,680
4,19,28,1,360000,372600,12600,680
4,19,30,5,372900,397200,24300,264
4,19,32,4,397800,412200,14400,289
4,19,34,1,412800,446400,33600,680
5,19,35,1,446400,473400,27000,680
5,19,37,4,475200,480600,5400,567
5,19,39,1,481800,532800,51000,680
6,19,40,1,532800,579600,46800,680
6,19,42,3,580800,583200,2400,210
6,19,44,3,584400,587700,3300,100
6,19,46,1,588600,604800,16200,680
0,20,0,1,0,34800,34800,678
0,20,2,4,36600,43200,6600,343
0,20,4,4,45900,49500,3600,587
0,20,6,1,50460,100800,50340,678
1,20,7,1,100800,110100,9300,678
1,20,9,4,111900,135000,23100,397
1,20,11,3,136200,137400,1200,125
1,20,13,3,139200,140100,900,178
1,20,15,4,142800,144600,1800,329
1,20,17,1,146700,187200,40500,678
2,20,18,1,187200,196500,9300,678
2,20,20,4,198300,221400,23100,618
2,20,22,3,222600,223800,1200,153
2,20,24,3,225600,226500,900,229
2,20,26,4,229200,231000,1800,284
2,20,28,1,233100,273600,40500,678
3,20,29,1,273600,282900,9300,678
3,20,31,4,284700,307800,23100,455
3,20,33,3,309000,310200,1200,148
3,20,35,3,312000,312900,900,216
3,20,37,4,315600,317400,1800,587
3,20,39,1,319500,360000,40500,678
4,20,40,1,360000,369900,9900,678
4,20,42,4,370800,375300,4500,357
4,20,44,1,375960,378900,2940,678
4,20,46,4,381600,385200,3600,375
4,20,48,1,387600,396900,9300,678
4,20,50,3,397800,398700,900,3
4,20,52,4,399000,403200,4200,556
4,20,54,4,404400,412200,7800,500
4,20,56,1,414600,446400,31800,678
5,20,57,1,446400,532800,86400,678
6,20,58,1,532800,556200,23400,678
6,20,60,7,556620,561180,4560,32
6,20,62,1,561600,604800,43200,678
0,21,0,1,0,27000,27000,697
0,21,2,4,27600,28200,600,294
0,21,4,4,28500,100800,72300,322
1,21,5,1,100800,112500,11700,697
1,21,7,4,114300,120600,6300,618
1,21,9,1,122400,129600,7200,697
1,21,11,4,130800,140400,9600,568
1,21,13,1,141600,187200,45600,697
2,21,14,1,187200,198900,11700,697
2,21,16,4,200700,207000,6300,615
2,21,18,1,208800,216000,7200,697
2,21,20,4,217200,226800,9600,451
2,21,22,1,228000,273600,45600,697
3,21,23,1,273600,285300,11700,697
3,21,25,4,287100,293400,6300,620
3,21,27,1,295200,302400,7200,697
3,21,29,4,303600,313200,9600,418
3,21,31,1,314400,360000,45600,697
4,21,32,1,360000,373500,13500,697
4,21,34,2,374400,406800,32400,263
4,21,36,1,408300,426600,18300,697
4,21,38,7,428700,432300,3600,192
5,21,40,1,434100,446400,12300,697
5,21,41,1,446400,505020,58620,697
5,21,43,4,506460,532800,26340,632
6,21,44,1,532800,551700,18900,697
6,21,46,7,552600,566520,13920,192
6,21,48,4,566880,567180,300,368
6,21,50,4,567600,574800,7200,540
6,21,52,4,576000,578400,2400,415
6,21,54,4,579000,590700,11700,308
6,21,56,1,590820,604800,13980,697
0,22,0,1,0,29700,29700,718
0,22,2,4,30060,30360,300,529
0,22,4,4,30780,31080,300,546
0,22,6,3,31200,31800,600,112
0,22,8,1,32100,40500,8400,718
0,22,10,4,41100,41400,300,283
0,22,12,4,44100,49500,5400,340
0,22,14,1,49800,54000,4200,718
0,22,16,4,54420,55800,1380,550
0,22,18,1,56100,64800,8700,718
0,22,20,4,66300,70200,3900,457
0,22,22,1,71400,100800,29400,718
1,22,23,1,100800,120300,19500,718
1,22,25,4,121500,122400,900,323
1,22,27,1,123600,134160,10560,718
1,22,29,2,135120,137340,2220,259
1,22,31,4,137580,138000,420,477
1,22,33,1,138960,139260,300,718
1,22,35,1,139500,152820,13320,718
1,22,37,4,154080,156000,1920,288
1,22,39,4,156180,157200,1020,571
1,22,41,4,158520,168300,9780,288
1,22,43,1,168480,187200,18720,718
2,22,44,1,187200,206700,19500,718
2,22,46,4,207900,208800,900,338
2,22,48,1,210000,220560,10560,718
2,22,50,2,221520,223740,2220,259
2,22,52,4,223980,224400,420,572
2,22,54,1,225360,225660,300,718
2,22,56,1,225900,239220,13320,718
2,22,58,4,240480,242400,1920,525
2,22,60,4,242580,243600,1020,390
2,22,62,4,244920,254700,9780,343
2,22,64,1,254880,273600,18720,718
3,22,65,1,273600,293100,19500,718
3,22,67,4,294300,295200,900,570
3,22,69,1,296400,306960,10560,718
3,22,71,2,307920,310140,2220,259
3,22,73,4,310380,310800,420,616
3,22,75,1,311760,312060,300,718
3,22,77,1,312300,325620,13320,718
3,22,79,4,326880,328800,1920,511
3,22,81,4,328980,330000,1020,415
3,22,83,4,331320,341100,9780,450
3,22,85,1,341280,360000,18720,718
4,22,86,2,360000,361800,1800,259
4,22,88,2,362820,364860,2040,259
4,22,90,2,369900,370800,900,259
4,22,92,2,374520,375960,1440,259
4,22,94,2,377460,380160,2700,259
4,22,96,2,382080,383220,1140,259
4,22,98,2,383640,385320,1680,259
4,22,100,2,391800,393480,1680,259
4,22,102,2,393660,394800,1140,259
4,22,104,3,399240,399540,300,13
4,22,106,2,400140,402420,2280,259
4,22,108,3,403380,404400,1020,29
4,22,110,1,404580,433500,28920,718
5,22,112,2,434040,437700,3660,259
5,22,114,2,438540,439260,720,259
5,22,116,2,441120,441840,720,259
5,22,118,2,443700,444060,360,259
5,22,120,2,444180,446400,2220,259
5,22,121,1,446400,478800,32400,718
5,22,123,4,479400,487800,8400,509
5,22,125,4,488400,489600,1200,472
5,22,127,1,490500,495000,4500,718
5,22,129,7,497700,505800,8100,191
5,22,131,3,509400,510300,900,15
5,22,133,1,511200,532800,21600,718
6,22,134,1,532800,556200,23400,718
6,22,136,7,557220,567000,9780,191
6,22,138,1,568020,604800,36780,718
0,23,0,1,0,27900,27900,721
0,23,2,4,28500,32700,4200,587
0,23,4,1,33120,34500,1380,721
0,23,6,2,35400,43320,7920,620
0,23,8,4,43800,47280,3480,500
0,23,10,2,47880,67920,20040,620
0,23,12,1,69000,72360,3360,721
0,23,14,1,74820,100800,25980,721
1,23,15,1,100800,187200,86400,721
2,23,16,1,187200,273600,86400,721
3,23,17,1,273600,360000,86400,721
4,23,18,1,360000,379800,19800,721
4,23,20,3,380700,384300,3600,49
4,23,22,2,387900,410400,22500,620
4,23,24,1,414000,446400,32400,721
5,23,25,1,446400,455400,9000,721
5,23,27,4,455700,459000,3300,343
5,23,29,1,459300,481260,21960,721
5,23,31,3,482700,483900,1200,59
5,23,33,3,484200,486900,2700,245
5,23,35,4,487080,490380,3300,385
5,23,37,1,491640,532800,41160,721
6,23,38,1,532800,554400,21600,721
6,23,40,7,557100,563400,6300,189
6,23,42,1,567000,604800,37800,721
0,24,0,1,0,37800,37800,667
0,24,2,3,38520,41400,2880,110
0,24,4,1,42240,100800,58560,667
1,24,5,1,100800,112800,12000,667
1,24,7,4,115440,119700,4260,576
1,24,9,1,121200,139500,18300,667
1,24,11,3,140400,142500,2100,126
1,24,13,1,143460,187200,43740,667
2,24,14,1,187200,199200,12000,667
2,24,16,4,201840,206100,4260,379
2,24,18,1,207600,225900,18300,667
2,24,20,3,226800,228900,2100,157
2,24,22,1,229860,273600,43740,667
3,24,23,1,273600,285600,12000,667
3,24,25,4,288240,292500,4260,479
3,24,27,1,294000,312300,18300,667
3,24,29,3,313200,315300,2100,121
3,24,31,1,316260,360000,43740,667
4,24,32,1,360000,375000,15000,667
4,24,34,4,375660,380280,4620,592
4,24,36,1,381060,384600,3540,667
4,24,38,2,386100,388800,2700,532
4,24,40,4,389700,393000,3300,454
4,24,42,2,393600,395400,1800,532
4,24,44,2,396000,406800,10800,532
4,24,46,4,409020,421200,12180,524
4,24,48,1,423420,446400,22980,667
5,24,49,1,446400,471600,25200,667
5,24,51,4,474300,482400,8100,288
5,24,53,4,484800,491580,6780,557
5,24,55,1,492600,499500,6900,667
5,24,57,3,500400,501600,1200,158
5,24,59,4,502200,503220,1020,330
5,24,61,1,503760,525300,21540,667
6,24,63,1,526680,532800,6120,667
6,24,64,1,532800,548100,15300,667
6,24,66,4,562500,564300,1800,596
6,24,68,1,580560,604800,24240,667
0,25,0,1,0,27600,27600,707
0,25,2,5,27900,52500,24600,262
0,25,4,1,52740,100800,48060,707
1,25,5,1,100800,126000,25200,707
1,25,7,4,126300,127200,900,568
1,25,9,4,127800,128400,600,415
1,25,11,4,129000,132300,3300,609
1,25,13,4,132600,136200,3600,426
1,25,15,4,136620,136980,360,389
1,25,17,1,137880,187200,49320,707
2,25,18,1,187200,212400,25200,707
2,25,20,4,212700,213600,900,308
2,25,22,4,214200,214800,600,568
2,25,24,4,215400,218700,3300,591
2,25,26,4,219000,222600,3600,560
2,25,28,4,223020,223380,360,277
2,25,30,1,224280,273600,49320,707
3,25,31,1,273600,298800,25200,707
3,25,33,4,299100,300000,900,631
3,25,35,4,300600,301200,600,434
3,25,37,4,301800,305100,3300,347
3,25,39,4,305400,309000,3600,453
3,25,41,4,309420,309780,360,306
3,25,43,1,310680,360000,49320,707
4,25,44,1,360000,372000,12000,707
4,25,46,5,372600,406500,33900,262
4,25,48,1,407100,446400,39300,707
5,25,49,1,446400,532800,86400,707
6,25,50,1,532800,572400,39600,707
6,25,52,4,572520,582300,9780,538
6,25,54,1,582420,604800,22380,707
0,26,0,4,0,14400,14400,509
0,26,2,1,14520,26400,11880,649
0,26,4,4,27000,27300,300,529
0,26,6,2,27900,54000,26100,406
0,26,8,4,54900,56400,1500,465
0,26,10,4,57300,58500,1200,613
0,26,12,2,58800,64800,6000,406
0,26,14,4,65100,67500,2400,433
0,26,16,3,68400,72000,3600,232
0,26,18,3,72600,74100,1500,130
0,26,20,1,74700,100800,26100,649
1,26,21,1,100800,135960,35160,649
1,26,23,4,137700,144000,6300,287
1,26,25,1,145560,187200,41640,649
2,26,26,1,187200,222360,35160,649
2,26,28,4,224100,230400,6300,471
2,26,30,1,231960,273600,41640,649
3,26,31,1,273600,308760,35160,649
3,26,33,4,310500,316800,6300,471
3,26,35,1,318360,360000,41640,649
4,26,36,1,360000,378900,18900,649
4,26,38,4,380340,381900,1560,511
4,26,40,3,382680,385680,3000,63
4,26,42,4,386040,389100,3060,373
4,26,44,3,389460,393780,4320,240
4,26,46,3,393960,397140,3180,33
4,26,48,1,398880,446400,47520,649
5,26,49,1,446400,478800,32400,649
5,26,51,3,479400,483000,3600,54
5,26,53,1,483600,532800,49200,649
6,26,54,1,532800,572400,39600,649
6,26,56,4,572580,572880,300,286
6,26,58,3,573000,573300,300,28
6,26,60,4,579600,604800,25200,529
0,27,0,1,0,23400,23400,676
0,27,2,4,25230,25530,300,358
0,27,4,4,26940,27240,300,568
0,27,6,4,32430,32730,300,368
0,27,8,4,33000,38040,5040,419
0,27,10,4,39270,39570,300,322
0,27,12,4,41400,41700,300,561
0,27,14,1,44100,100800,56700,676
1,27,15,1,100800,115200,14400,676
1,27,17,2,118800,151200,32400,555
1,27,19,1,154800,187200,32400,676
2,27,20,1,187200,201600,14400,676
2,27,22,2,205200,237600,32400,555
2,27,24,1,241200,273600,32400,676
3,27,25,1,273600,288000,14400,676
3,27,27,2,291600,324000,32400,555
3,27,29,1,327600,360000,32400,676
4,27,30,1,360000,374400,14400,676
4,27,32,4,374820,375120,300,432
4,27,34,1,375600,412500,36900,676
4,27,36,3,412920,414000,1080,20
4,27,38,4,414600,415200,600,308
4,27,40,1,415800,446400,30600,676
5,27,41,1,446400,460800,14400,676
5,27,43,4,463500,465300,1800,294
5,27,45,4,466200,468000,1800,329
5,27,47,3,468300,469800,1500,181
5,27,49,4,470220,470700,480,313
5,27,51,1,471300,532800,61500,676
6,27,52,1,532800,604800,72000,676
0,28,0,4,0,14400,14400,382
0,28,2,1,14520,27900,13380,690
0,28,4,5,28500,51300,22800,270
0,28,6,1,51900,100800,48900,690
1,28,7,1,100800,115920,15120,690
1,28,9,5,117060,141300,24240,270
1,28,11,1,143160,187200,44040,690
2,28,12,1,187200,202320,15120,690
2,28,14,5,203460,227700,24240,270
2,28,16,1,229560,273600,44040,690
3,28,17,1,273600,288720,15120,690
3,28,19,5,289860,314100,24240,270
3,28,21,1,315960,360000,44040,690
4,28,22,1,360000,373200,13200,690
4,28,24,4,373740,374040,300,308
4,28,26,1,374400,376080,1680,690
4,28,28,5,376200,402600,26400,270
4,28,30,1,402900,411000,8100,690
4,28,32,4,412200,419400,7200,431
4,28,34,1,420600,446400,25800,690
5,28,35,1,446400,463500,17100,690
5,28,37,4,464400,468000,3600,552
5,28,39,3,468300,469800,1500,76
5,28,41,1,470700,479520,8820,690
5,28,43,4,484800,502800,18000,596
5,28,45,1,507600,532800,25200,690
6,28,46,4,532800,604800,72000,618
0,29,0,1,0,100800,100800,641
1,29,1,1,100800,112380,11580,641
1,29,3,2,113160,148560,35400,258
1,29,5,1,149580,187200,37620,641
2,29,6,1,187200,198780,11580,641
2,29,8,2,199560,234960,35400,258
2,29,10,1,235980,273600,37620,641
3,29,11,1,273600,285180,11580,641
3,29,13,2,285960,321360,35400,258
3,29,15,1,322380,360000,37620,641
4,29,16,1,360000,361800,1800,641
4,29,18,4,365400,365700,300,382
4,29,20,2,366480,412200,45720,258
4,29,22,4,412500,413100,600,577
4,29,24,4,415860,446400,30540,374
5,29,25,1,446400,532800,86400,641
6,29,26,1,532800,585000,52200,641
6,29,28,4,585720,600180,14460,452
6,29,30,1,601020,604800,3780,641
0,30,2,1,14520,100800,86280,710
1,30,3,1,100800,187200,86400,710
2,30,4,1,187200,273600,86400,710
3,30,5,1,273600,360000,86400,710
4,30,6,1,360000,381600,21600,710
4,30,8,4,382500,386400,3900,625
4,30,10,3,387000,389400,2400,41
4,30,12,1,390600,415800,25200,710
4,30,14,3,416400,418800,2400,170
4,30,16,1,419400,446400,27000,710
5,30,17,1,446400,467700,21300,710
5,30,19,2,468000,474600,6600,355
5,30,21,1,474900,481500,6600,710
5,30,23,2,483000,487800,4800,355
5,30,25,1,489000,497700,8700,710
5,30,27,4,500400,509400,9000,620
5,30,29,1,510600,532800,22200,710
0,31,0,1,0,41940,41940,664
0,31,2,3,42060,42360,300,255
0,31,4,1,42480,100800,58320,664
1,31,5,1,100800,115320,14520,664
1,31,7,1,117060,125280,8220,664
1,31,9,4,128580,129360,780,529
1,31,11,4,130920,139920,9000,575
1,31,13,4,141480,145380,3900,551
1,31,15,3,145800,150420,4620,186
1,31,17,1,154500,187200,32700,664
2,31,18,1,187200,201720,14520,664
2,31,20,1,203460,211680,8220,664
2,31,22,4,214980,215760,780,354
2,31,24,4,217320,226320,9000,470
2,31,26,4,227880,231780,3900,349
2,31,28,3,232200,236820,4620,145
2,31,30,1,240900,273600,32700,664
3,31,31,1,273600,288120,14520,664
3,31,33,1,289860,298080,8220,664
3,31,35,4,301380,302160,780,556
3,31,37,4,303720,312720,9000,635
3,31,39,4,314280,318180,3900,283
3,31,41,3,318600,323220,4620,18
3,31,43,1,327300,360000,32700,664
4,31,44,1,360000,370800,10800,664
4,31,46,6,372600,398700,26100,259
4,31,48,1,400500,446400,45900,664
5,31,49,4,446400,532800,86400,568
6,31,50,1,532800,562200,29400,664
6,31,52,4,562500,566100,3600,478
6,31,54,1,566400,604800,38400,664
0,32,0,1,0,25620,25620,672
0,32,2,4,26400,30300,3900,602
0,32,4,2,30540,48000,17460,366
0,32,6,4,48120,48420,300,614
0,32,8,2,48540,67860,19320,366
0,32,10,1,68700,100800,32100,672
1,32,11,1,100800,145800,45000,672
1,32,13,2,147000,165600,18600,366
1,32,15,3,166500,166920,420,21
1,32,17,1,168180,187200,19020,672
2,32,18,1,187200,232200,45000,672
2,32,20,2,233400,252000,18600,366
2,32,22,3,252900,253320,420,185
2,32,24,1,254580,273600,19020,672
3,32,25,1,273600,318600,45000,672
3,32,27,2,319800,338400,18600,366
3,32,29,3,339300,339720,420,96
3,32,31,1,340980,360000,19020,672
4,32,32,1,360000,372720,12720,672
4,32,34,2,374580,405900,31320,366
4,32,36,4,407220,412200,4980,277
4,32,38,4,412740,413040,300,455
4,32,40,4,414000,417300,3300,524
4,32,42,1,418200,446400,28200,672
5,32,43,1,446400,469800,23400,672
5,32,45,4,471600,480600,9000,523
5,32,47,1,482400,532800,50400,672
6,32,48,1,532800,549000,16200,672
6,32,50,2,551460,575400,23940,366
6,32,52,1,577320,589200,11880,672
6,32,54,1,591000,604800,13800,672
0,33,0,1,0,25680,25680,699
0,33,2,5,28500,54300,25800,262
0,33,4,4,55200,56700,1500,568
0,33,6,1,59400,100800,41400,699
1,33,7,1,100800,111600,10800,699
1,33,9,4,113400,114000,600,568
1,33,11,5,114600,139200,24600,262
1,33,13,4,140400,140700,300,609
1,33,15,1,141900,145800,3900,699
1,33,17,4,149400,154800,5400,436
1,33,19,1,157500,187200,29700,699
2,33,20,1,187200,198000,10800,699
2,33,22,4,199800,200400,600,501
2,33,24,5,201000,225600,24600,262
2,33,26,4,226800,227100,300,395
2,33,28,1,228300,232200,3900,699
2,33,30,4,235800,241200,5400,322
2,33,32,1,243900,273600,29700,699
3,33,33,1,273600,284400,10800,699
3,33,35,4,286200,286800,600,455
3,33,37,5,287400,312000,24600,262
3,33,39,4,313200,313500,300,620
3,33,41,1,314700,318600,3900,699
3,33,43,4,322200,327600,5400,618
3,33,45,1,330300,360000,29700,699
4,33,46,1,360000,370500,10500,699
4,33,48,4,370620,370920,300,510
4,33,50,5,372300,396780,24480,262
4,33,52,1,398640,405660,7020,699
4,33,54,4,406560,410520,3960,466
4,33,56,1,411420,412560,1140,699
4,33,58,4,413100,423120,10020,524
4,33,60,1,423660,446400,22740,699
5,33,61,1,446400,532800,86400,699
6,33,62,1,532800,541770,8970,699
6,33,64,4,541890,542670,780,614
6,33,66,1,542790,590370,47580,699
6,33,68,4,590490,591270,780,552
6,33,70,1,591390,604800,13410,699
0,34,0,1,0,30960,30960,661
0,34,2,2,32160,51120,18960,266
0,34,4,4,51540,53880,2340,467
0,34,6,2,54360,63840,9480,266
0,34,8,1,65220,100800,35580,661
1,34,9,1,100800,123900,23100,661
1,34,11,4,124500,126300,1800,292
1,34,13,1,126900,187200,60300,661
2,34,14,1,187200,210300,23100,661
2,34,16,4,210900,212700,1800,361
2,34,18,1,213300,273600,60300,661
3,34,19,1,273600,296700,23100,661
3,34,21,4,297300,299100,1800,558
3,34,23,1,299700,360000,60300,661
4,34,24,1,360000,372000,12000,661
4,34,26,2,373200,389700,16500,266
4,34,28,4,390600,391500,900,341
4,34,30,3,392100,394200,2100,131
4,34,32,1,395100,410400,15300,661
4,34,34,4,411300,416700,5400,559
4,34,36,3,417300,420300,3000,157
4,34,38,1,421200,446400,25200,661
5,34,39,1,446400,472800,26400,661
5,34,41,3,473400,477900,4500,84
5,34,43,1,478200,486000,7800,661
5,34,45,4,486300,504000,17700,587
5,34,47,1,504300,532800,28500,661
6,34,48,1,532800,557400,24600,661
6,34,50,7,558000,562800,4800,188
6,34,52,1,563400,581400,18000,661
6,34,54,4,582000,595800,13800,415
6,34,56,1,596400,604800,8400,661
0,35,0,1,0,26100,26100,660
0,35,2,4,27000,27300,300,477
0,35,4,3,27900,34800,6900,222
0,35,6,4,35700,39300,3600,397
0,35,8,1,40500,46800,6300,660
0,35,10,3,47400,51000,3600,213
0,35,12,1,51600,100800,49200,660
1,35,13,1,100800,148500,47700,660
1,35,15,4,149400,152100,2700,609
1,35,17,1,153000,187200,34200,660
2,35,18,1,187200,234900,47700,660
2,35,20,4,235800,238500,2700,302
2,35,22,1,239400,273600,34200,660
3,35,23,1,273600,321300,47700,660
3,35,25,4,322200,324900,2700,366
3,35,27,1,325800,360000,34200,660
4,35,28,4,360000,367500,7500,563
4,35,30,1,370800,380400,9600,660
4,35,32,4,380700,381000,300,294
4,35,34,4,381600,381900,300,337
4,35,36,3,382200,382500,300,46
4,35,38,4,383220,384540,1320,568
4,35,40,1,385380,446400,61020,660
5,35,41,1,446400,475620,29220,660
5,35,43,4,480180,497400,17220,415
5,35,45,3,499020,499800,780,219
5,35,47,1,502500,532800,30300,660
6,35,48,1,532800,558000,25200,660
6,35,50,7,558600,561600,3000,201
6,35,52,1,562200,604800,42600,660
0,36,0,1,0,14400,14400,654
0,36,2,4,14520,25500,10980,590
0,36,4,1,30300,34200,3900,654
0,36,6,4,35400,38400,3000,483
0,36,8,2,39600,42300,2700,608
0,36,10,1,44100,49800,5700,654
0,36,12,4,50520,51000,480,463
0,36,14,4,51300,54300,3000,618
0,36,16,4,54720,55500,780,583
0,36,18,1,56400,100800,44400,654
1,36,19,1,100800,108900,8100,654
1,36,21,1,109500,109800,300,654
1,36,23,2,111900,140400,28500,608
1,36,25,1,142800,143400,600,654
1,36,27,1,144300,187200,42900,654
2,36,28,1,187200,195300,8100,654
2,36,30,1,195900,196200,300,654
2,36,32,2,198300,226800,28500,608
2,36,34,1,229200,229800,600,654
2,36,36,1,230700,273600,42900,654
3,36,37,1,273600,281700,8100,654
3,36,39,1,282300,282600,300,654
3,36,41,2,284700,313200,28500,608
3,36,43,1,315600,316200,600,654
3,36,45,1,317100,360000,42900,654
4,36,46,2,360000,371400,11400,608
4,36,48,2,375120,419100,43980,608
4,36,50,3,421200,422700,1500,138
4,36,52,1,424680,446400,21720,654
5,36,53,1,446400,478800,32400,654
5,36,55,4,480960,488700,7740,444
5,36,57,1,489960,532800,42840,654
6,36,58,1,532800,548700,15900,654
6,36,60,7,551100,561600,10500,201
6,36,62,1,564000,604800,40800,654
0,37,0,1,0,34200,34200,653
0,37,2,2,35700,89100,53400,384
1,37,4,1,91200,100800,9600,653
1,37,5,1,100800,187200,86400,653
2,37,6,1,187200,273600,86400,653
3,37,7,1,273600,360000,86400,653
4,37,8,1,360000,410400,50400,653
4,37,10,4,411600,415800,4200,540
4,37,12,1,417000,446400,29400,653
5,37,13,1,446400,468000,21600,653
5,37,15,3,468900,475200,6300,238
5,37,17,3,475500,480600,5100,134
5,37,19,3,480900,486000,5100,53
5,37,21,1,487200,532800,45600,653
6,37,22,1,532800,604800,72000,653
0,38,0,1,0,100800,100800,657
1,38,1,1,100800,115200,14400,657
1,38,3,1,116100,122400,6300,657
1,38,5,3,126000,130200,4200,226
1,38,7,1,132300,135900,3600,657
1,38,9,4,139500,142200,2700,432
1,38,11,4,144000,151200,7200,211
1,38,13,1,154800,187200,32400,657
2,38,14,1,187200,201600,14400,657
2,38,16,1,202500,208800,6300,657
2,38,18,3,212400,216600,4200,253
2,38,20,1,218700,222300,3600,657
2,38,22,4,225900,228600,2700,568
2,38,24,4,230400,237600,7200,371
2,38,26,1,241200,273600,32400,657
3,38,27,1,273600,288000,14400,657
3,38,29,1,288900,295200,6300,657
3,38,31,3,298800,303000,4200,142
3,38,33,1,305100,308700,3600,657
3,38,35,4,312300,315000,2700,394
3,38,37,4,316800,324000,7200,312
3,38,39,1,327600,360000,32400,657
4,38,42,3,422280,422820,540,185
4,38,44,1,423120,446400,23280,657
5,38,45,1,446400,467700,21300,657
5,38,47,4,468000,468600,600,415
5,38,49,3,469800,475020,5220,73
5,38,51,3,475620,477780,2160,61
5,38,53,3,478260,478560,300,223
5,38,55,1,479460,532800,53340,657
6,38,56,1,532800,549000,16200,657
6,38,58,4,549600,552000,2400,405
6,38,60,7,553500,554400,900,92
6,38,62,1,555600,604800,49200,657
0,39,0,1,0,38700,38700,724
0,39,2,4,39600,62100,22500,402
0,39,4,1,63000,66600,3600,724
0,39,6,4,68400,75600,7200,290
0,39,8,4,77400,100800,23400,477
1,39,9,1,100800,117000,16200,724
1,39,11,2,118800,151200,32400,118
1,39,13,1,153000,187200,34200,724
2,39,14,1,187200,203400,16200,724
2,39,16,2,205200,237600,32400,118
2,39,18,1,239400,273600,34200,724
3,39,19,1,273600,289800,16200,724
3,39,21,2,291600,324000,32400,118
3,39,23,1,325800,360000,34200,724
4,39,24,1,360000,394800,34800,724
4,39,26,2,395700,425220,29520,118
4,39,28,1,426180,446400,20220,724
5,39,29,1,446400,489600,43200,724
5,39,31,3,490800,492300,1500,221
5,39,33,3,492600,493200,600,124
5,39,35,3,493800,495000,1200,172
5,39,37,1,495900,502200,6300,724
5,39,39,4,504000,525300,21300,585
6,39,41,1,527400,532800,5400,724
6,39,42,1,532800,543000,10200,724
6,39,44,2,543480,584100,40620,118
6,39,46,3,584580,585900,1320,176
6,39,48,1,586920,604800,17880,724
0,40,0,1,0,34200,34200,726
0,40,2,4,35100,54000,18900,507
0,40,4,3,54900,59400,4500,75
0,40,6,1,60300,100800,40500,726
1,40,7,4,100800,121140,20340,477
1,40,9,4,122400,125100,2700,456
1,40,11,4,126000,128700,2700,574
1,40,13,1,130500,136800,6300,726
1,40,15,4,137700,138600,900,587
1,40,17,4,139200,187200,48000,355
2,40,18,4,187200,207540,20340,291
2,40,20,4,208800,211500,2700,570
2,40,22,4,212400,215100,2700,337
2,40,24,1,216900,223200,6300,726
2,40,26,4,224100,225000,900,415
2,40,28,4,225600,273600,48000,517
3,40,29,4,273600,293940,20340,455
3,40,31,4,295200,297900,2700,343
3,40,33,4,298800,301500,2700,505
3,40,35,1,303300,309600,6300,726
3,40,37,4,310500,311400,900,385
3,40,39,4,312000,360000,48000,629
4,40,40,1,360000,378000,18000,726
4,40,42,4,379800,387600,7800,572
4,40,44,3,388680,390600,1920,78
4,40,46,4,390900,391200,300,581
4,40,48,4,391680,393360,1680,324
4,40,50,1,394320,446400,52080,726
5,40,51,1,446400,452100,5700,726
5,40,53,4,452700,457200,4500,343
5,40,55,4,457800,496800,39000,312
5,40,57,1,508200,532800,24600,726
6,40,58,1,532800,571200,38400,726
6,40,60,3,571800,572700,900,139
6,40,62,1,573300,604800,31500,726
0,41,0,1,0,39000,39000,704
0,41,2,5,39600,60420,20820,262
0,41,4,1,61200,100800,39600,704
1,41,5,1,100800,115800,15000,704
1,41,7,5,116700,119400,2700,262
1,41,9,4,120000,124200,4200,620
1,41,11,5,124800,149400,24600,262
1,41,13,1,150300,187200,36900,704
2,41,14,1,187200,202200,15000,704
2,41,16,5,203100,205800,2700,262
2,41,18,4,206400,210600,4200,552
2,41,20,5,211200,235800,24600,262
2,41,22,1,236700,273600,36900,704
3,41,23,1,273600,288600,15000,704
3,41,25,5,289500,292200,2700,262
3,41,27,4,292800,297000,4200,609
3,41,29,5,297600,322200,24600,262
3,41,31,1,323100,360000,36900,704
4,41,32,1,360000,410370,50370,704
4,41,34,4,410490,418470,7980,552
4,41,36,1,418590,446400,27810,704
5,41,37,1,446400,464400,18000,704
5,41,39,4,465300,469200,3900,568
5,41,41,4,469800,472500,2700,618
5,41,43,4,475200,475500,300,326
5,41,45,3,476400,477900,1500,140
5,41,47,4,481500,496800,15300,563
5,41,49,4,497400,497700,300,396
5,41,51,4,498600,505800,7200,610
5,41,53,1,513000,532800,19800,704
6,41,54,1,532800,555600,22800,704
6,41,56,7,555780,565620,9840,91
6,41,58,1,565800,604800,39000,704
0,42,0,1,0,100800,100800,695
1,42,1,1,100800,187200,86400,695
2,42,2,1,187200,273600,86400,695
3,42,3,1,273600,360000,86400,695
4,42,4,1,360000,397800,37800,695
4,42,6,3,398100,399600,1500,25
4,42,8,3,399780,400320,540,116
4,42,10,3,400500,401100,600,66
4,42,12,1,401400,446400,45000,695
5,42,13,3,446400,459600,13200,54
5,42,15,3,462000,465600,3600,78
5,42,17,3,466800,467700,900,71
5,42,19,3,468900,473400,4500,25
5,42,21,1,474300,483900,9600,695
5,42,23,4,486600,532800,46200,517
6,42,24,1,532800,555300,22500,695
6,42,26,7,555600,561600,6000,189
6,42,28,3,561900,562200,300,134
6,42,30,1,562500,604800,42300,695
0,43,0,1,0,27600,27600,669
0,43,2,2,28800,61200,32400,545
0,43,4,1,62520,100800,38280,669
1,43,5,2,100800,138480,37680,545
1,43,7,1,140100,187200,47100,669
2,43,8,2,187200,224880,37680,545
2,43,10,1,226500,273600,47100,669
3,43,11,2,273600,311280,37680,545
3,43,13,1,312900,360000,47100,669
4,43,14,1,360000,371700,11700,669
4,43,16,2,372780,404100,31320,545
4,43,18,1,405420,446400,40980,669
5,43,19,1,446400,532800,86400,669
6,43,20,1,532800,572400,39600,669
6,43,22,4,573000,585300,12300,587
6,43,24,4,585900,586500,600,380
6,43,26,1,587100,604800,17700,669
0,44,0,1,0,23370,23370,691
0,44,2,1,23490,25170,1680,691
0,44,4,1,25290,41400,16110,691
0,44,6,4,42300,52200,9900,620
0,44,8,1,53100,55800,2700,691
0,44,10,4,56400,64800,8400,337
0,44,12,1,65400,100800,35400,691
1,44,13,1,100800,164700,63900,691
1,44,15,4,165600,172200,6600,401
1,44,17,1,172500,187200,14700,691
2,44,18,1,187200,251100,63900,691
2,44,20,4,252000,258600,6600,477
2,44,22,1,258900,273600,14700,691
3,44,23,1,273600,337500,63900,691
3,44,25,4,338400,345000,6600,337
3,44,27,1,345300,360000,14700,691
4,44,28,1,360000,446400,86400,691
5,44,29,1,446400,532800,86400,691
6,44,30,1,532800,565200,32400,691
6,44,32,4,567000,570600,3600,284
6,44,34,1,572400,604800,32400,691
0,45,0,1,0,27000,27000,687
0,45,2,5,28200,49800,21600,271
0,45,4,1,51000,100800,49800,687
1,45,5,1,100800,112320,11520,687
1,45,7,5,113100,140700,27600,271
1,45,9,1,141840,187200,45360,687
2,45,10,1,187200,198720,11520,687
2,45,12,5,199500,227100,27600,271
2,45,14,1,228240,273600,45360,687
3,45,15,1,273600,285120,11520,687
3,45,17,5,285900,313500,27600,271
3,45,19,1,314640,360000,45360,687
4,45,20,1,360000,372600,12600,687
4,45,22,5,373020,399060,26040,271
4,45,24,1,399540,399900,360,687
4,45,26,4,400920,403800,2880,506
4,45,28,1,404700,406800,2100,687
4,45,30,4,408840,409440,600,381
4,45,32,1,411900,417600,5700,687
4,45,34,4,418200,421200,3000,294
4,45,36,1,421680,446400,24720,687
5,45,37,1,446400,495000,48600,687
5,45,39,4,495180,505200,10020,631
5,45,41,1,505500,532800,27300,687
6,45,42,1,532800,565200,32400,687
6,45,44,4,565800,569400,3600,326
6,45,46,3,569700,573300,3600,149
6,45,48,1,573900,604800,30900,687
0,46,0,1,0,27600,27600,727
0,46,2,2,29700,44100,14400,430
0,46,4,2,45420,61680,16260,430
0,46,6,1,63600,100800,37200,727
1,46,7,4,100800,187200,86400,441
2,46,8,4,187200,273600,86400,521
3,46,9,4,273600,360000,86400,349
4,46,10,1,360000,368100,8100,727
4,46,12,2,371580,389100,17520,430
4,46,14,3,392700,393600,900,165
4,46,16,1,394080,408600,14520,727
4,46,18,4,410400,417600,7200,422
4,46,20,1,419400,420000,600,727
4,46,22,1,421200,446400,25200,727
5,46,23,1,446400,532800,86400,727
6,46,24,1,532800,561600,28800,727
6,46,26,2,562200,563400,1200,430
6,46,28,1,564000,604800,40800,727
0,47,0,1,0,29700,29700,712
0,47,2,4,30600,30900,300,514
0,47,4,2,31500,43200,11700,339
0,47,6,2,46200,52800,6600,339
0,47,8,2,56700,58500,1800,339
0,47,10,1,59400,100800,41400,712
1,47,11,1,100800,111720,10920,712
1,47,13,2,115200,146100,30900,339
1,47,15,1,151980,153750,1770,712
1,47,17,1,153870,187200,33330,712
2,47,18,1,187200,198120,10920,712
2,47,20,2,201600,232500,30900,339
2,47,22,1,238380,240150,1770,712
2,47,24,1,240270,273600,33330,712
3,47,25,1,273600,284520,10920,712
3,47,27,2,288000,318900,30900,339
3,47,29,1,324780,326550,1770,712
3,47,31,1,326670,360000,33330,712
4,47,32,1,360000,369000,9000,712
4,47,34,2,372000,385320,13320,339
4,47,36,4,386160,388020,1860,542
4,47,38,3,390300,391800,1500,183
4,47,40,1,392640,446400,53760,712
5,47,41,1,446400,478800,32400,712
5,47,43,4,479700,486300,6600,371
5,47,45,3,486900,488400,1500,228
5,47,47,1,489600,532800,43200,712
6,47,48,1,532800,552900,20100,712
6,47,50,7,553500,558000,4500,93
6,47,52,3,558600,561300,2700,86
6,47,54,1,561900,567000,5100,712
6,47,56,3,568800,570600,1800,22
6,47,58,1,572400,604800,32400,712
0,48,0,1,0,27000,27000,640
0,48,2,5,28320,55500,27180,272
0,48,4,1,56820,64200,7380,640
0,48,6,4,64800,68400,3600,579
0,48,8,1,69000,100800,31800,640
1,48,9,1,100800,114000,13200,640
1,48,11,5,114120,142800,28680,272
1,48,13,1,142980,187200,44220,640
2,48,14,1,187200,200400,13200,640
2,48,16,5,200520,229200,28680,272
2,48,18,1,229380,273600,44220,640
3,48,19,1,273600,286800,13200,640
3,48,21,5,286920,315600,28680,272
3,48,23,1,315780,360000,44220,640
4,48,24,1,360000,370800,10800,640
4,48,26,5,370920,399690,28770,272
4,48,28,4,399810,401160,1350,477
4,48,30,1,401400,446400,45000,640
5,48,31,1,446400,466200,19800,640
5,48,33,3,468000,471600,3600,21
5,48,35,3,471780,472500,720,7
5,48,37,3,472680,475200,2520,114
5,48,39,4,476700,477300,600,292
5,48,41,1,478980,532800,53820,640
6,48,42,1,532800,547800,15000,640
6,48,44,5,552600,581400,28800,272
6,48,46,1,583800,604800,21000,640
0,49,0,1,0,27600,27600,713
0,49,2,5,29400,56700,27300,261
0,49,4,1,59400,63600,4200,713
0,49,6,4,64800,69300,4500,337
0,49,8,3,70200,72000,1800,209
0,49,10,1,73200,100800,27600,713
1,49,11,1,100800,112800,12000,713
1,49,13,5,115380,141300,25920,261
1,49,15,1,144000,187200,43200,713
2,49,16,1,187200,199200,12000,713
2,49,18,5,201780,227700,25920,261
2,49,20,1,230400,273600,43200,713
3,49,21,1,273600,285600,12000,713
3,49,23,5,288180,314100,25920,261
3,49,25,1,316800,360000,43200,713
4,49,26,1,360000,371700,11700,713
4,49,28,5,372300,397500,25200,261
4,49,30,1,399360,404100,4740,713
4,49,32,4,404880,409440,4560,482
4,49,34,1,410040,446400,36360,713
5,49,35,1,446400,532800,86400,713
6,49,36,1,532800,556500,23700,713
6,49,38,4,557280,557700,420,477
6,49,40,4,561900,574800,12900,335
6,49,42,1,579000,580800,1800,713
6,49,44,3,582000,585900,3900,220
6,49,46,4,586500,589800,3300,528
6,49,48,1,591000,591300,300,713
6,49,50,1,593100,604800,11700,713
0,50,0,1,0,25200,25200,647
0,50,2,4,25500,25800,300,567
0,50,4,5,28200,55800,27600,262
0,50,6,1,59100,100800,41700,647
1,50,7,1,100800,121500,20700,647
1,50,9,5,122400,150000,27600,262
1,50,11,1,150900,187200,36300,647
2,50,12,1,187200,207900,20700,647
2,50,14,5,208800,236400,27600,262
2,50,16,1,237300,273600,36300,647
3,50,17,1,273600,294300,20700,647
3,50,19,5,295200,322800,27600,262
3,50,21,1,323700,360000,36300,647
4,50,22,1,360000,371100,11100,647
4,50,24,4,371220,371520,300,503
4,50,26,5,373080,402000,28920,262
4,50,28,1,403200,405000,1800,647
4,50,30,4,405600,409500,3900,575
4,50,32,1,410100,446400,36300,647
5,50,33,1,446400,475200,28800,647
5,50,35,4,476100,480600,4500,330
5,50,37,4,480780,491400,10620,570
5,50,39,1,492300,532800,40500,647
6,50,40,1,532800,572640,39840,647
6,50,42,4,573060,593760,20700,280
6,50,44,4,594480,595740,1260,319
6,50,46,1,595980,604800,8820,647
0,51,0,1,0,19800,19800,665
0,51,2,2,21900,67500,45600,265
0,51,4,1,69420,100800,31380,665
1,51,5,1,100800,108900,8100,665
1,51,7,2,109500,114300,4800,265
1,51,9,1,114480,120600,6120,665
1,51,11,7,120900,136200,15300,196
1,51,13,1,136500,137700,1200,665
1,51,15,2,138000,144900,6900,265
1,51,17,1,145020,187200,42180,665
2,51,18,1,187200,195300,8100,665
2,51,20,2,195900,200700,4800,265
2,51,22,1,200880,207000,6120,665
2,51,24,7,207300,222600,15300,196
2,51,26,1,222900,224100,1200,665
2,51,28,2,224400,231300,6900,265
2,51,30,1,231420,273600,42180,665
3,51,31,1,273600,281700,8100,665
3,51,33,2,282300,287100,4800,265
3,51,35,1,287280,293400,6120,665
3,51,37,7,293700,309000,15300,196
3,51,39,1,309300,310500,1200,665
3,51,41,2,310800,317700,6900,265
3,51,43,1,317820,360000,42180,665
4,51,44,1,360000,370320,10320,665
4,51,46,2,371460,403200,31740,265
4,51,48,1,404220,446400,42180,665
5,51,49,1,446400,466740,20340,665
5,51,51,3,467400,470400,3000,237
5,51,53,1,471120,532800,61680,665
6,51,54,1,532800,549900,17100,665
6,51,56,2,550620,569520,18900,265
6,51,58,1,570600,604800,34200,665
0,52,0,1,0,41400,41400,732
0,52,2,7,42300,47700,5400,94
0,52,4,1,48600,100800,52200,732
1,52,5,1,100800,111000,10200,732
1,52,7,4,111900,116700,4800,322
1,52,11,4,132000,133200,1200,355
1,52,13,4,134400,135000,600,619
1,52,15,4,135900,147600,11700,293
1,52,17,1,148500,187200,38700,732
2,52,18,1,187200,197400,10200,732
2,52,20,4,198300,203100,4800,575
2,52,24,4,218400,219600,1200,355
2,52,26,4,220800,221400,600,285
2,52,28,4,222300,234000,11700,622
2,52,30,1,234900,273600,38700,732
3,52,31,1,273600,283800,10200,732
3,52,33,4,284700,289500,4800,613
3,52,37,4,304800,306000,1200,471
3,52,39,4,307200,307800,600,433
3,52,41,4,308700,320400,11700,288
3,52,43,1,321300,360000,38700,732
4,52,44,1,360000,380700,20700,732
4,52,46,1,383400,385200,1800,732
4,52,48,3,385800,389100,3300,85
4,52,50,4,389700,393300,3600,592
4,52,52,3,393900,394800,900,167
4,52,54,4,397200,410400,13200,554
4,52,56,1,412800,446400,33600,732
5,52,57,1,446400,460800,14400,732
5,52,59,4,461700,468300,6600,289
5,52,61,1,469200,475500,6300,732
5,52,63,3,476100,480600,4500,160
5,52,65,1,480780,482400,1620,732
5,52,67,3,483300,491760,8460,134
5,52,69,3,493980,499800,5820,130
5,52,71,1,500400,532800,32400,732
6,52,72,1,532800,546300,13500,732
6,52,74,4,546840,556680,9840,613
6,52,76,1,557340,584400,27060,732
6,52,78,1,586320,604800,18480,732
0,53,0,4,0,14400,14400,366
0,53,2,1,14520,32400,17880,643
0,53,4,3,33600,37800,4200,54
0,53,6,1,39000,57600,18600,643
0,53,8,4,58800,61200,2400,568
0,53,10,1,62400,100800,38400,643
1,53,11,1,100800,137100,36300,643
1,53,13,2,137880,138180,300,455
1,53,15,3,138300,139800,1500,123
1,53,17,1,140700,187200,46500,643
2,53,18,1,187200,223500,36300,643
2,53,20,2,224280,224580,300,455
2,53,22,3,224700,226200,1500,12
2,53,24,1,227100,273600,46500,643
3,53,25,1,273600,309900,36300,643
3,53,27,2,310680,310980,300,455
3,53,29,3,311100,312600,1500,250
3,53,31,1,313500,360000,46500,643
4,53,32,1,360000,376020,16020,643
4,53,34,6,376200,380700,4500,260
4,53,36,3,381930,382230,300,106
4,53,38,2,385800,388800,3000,455
4,53,40,4,389700,392400,2700,392
4,53,42,1,393960,446400,52440,643
5,53,43,4,446400,532800,86400,395
6,53,44,4,532800,604800,72000,477
0,54,0,1,0,37800,37800,656
0,54,2,4,38400,42300,3900,304
0,54,4,1,42900,46200,3300,656
0,54,6,4,46800,47400,600,618
0,54,8,2,48000,73800,25800,500
0,54,10,1,74400,100800,26400,656
1,54,11,1,100800,114000,13200,656
1,54,13,6,114600,138600,24000,260
1,54,15,1,139200,142200,3000,656
1,54,17,4,142500,158100,15600,336
1,54,19,1,158400,187200,28800,656
2,54,20,1,187200,200400,13200,656
2,54,22,6,201000,225000,24000,260
2,54,24,1,225600,228600,3000,656
2,54,26,4,228900,244500,15600,343
2,54,28,1,244800,273600,28800,656
3,54,29,1,273600,286800,13200,656
3,54,31,6,287400,311400,24000,260
3,54,33,1,312000,315000,3000,656
3,54,35,4,315300,330900,15600,615
3,54,37,1,331200,360000,28800,656
4,54,38,1,360000,372600,12600,656
4,54,40,6,374400,385200,10800,260
4,54,42,4,386400,388800,2400,400
4,54,44,3,389700,391200,1500,82
4,54,46,4,391500,394200,2700,540
4,54,48,4,396000,446400,50400,615
5,54,49,1,446400,457200,10800,656
5,54,51,2,457920,481500,23580,500
5,54,53,1,482400,493200,10800,656
5,54,55,4,493800,495000,1200,455
5,54,57,4,498000,504600,6600,398
5,54,59,4,505200,506400,1200,294
5,54,61,1,509400,532800,23400,656
6,54,62,1,532800,558000,25200,656
6,54,64,4,558420,563520,5100,626
6,54,66,1,564000,575100,11100,656
6,54,68,2,575820,597720,21900,500
6,54,70,1,598200,604800,6600,656
0,55,0,1,0,22800,22800,715
0,55,2,2,25500,64800,39300,587
0,55,4,1,67500,100800,33300,715
1,55,5,3,100800,118800,18000,133
1,55,7,2,122400,151200,28800,587
1,55,9,3,154800,187200,32400,50
2,55,10,3,187200,205200,18000,80
2,55,12,2,208800,237600,28800,587
2,55,14,3,241200,273600,32400,182
3,55,15,3,273600,291600,18000,252
3,55,17,2,295200,324000,28800,587
3,55,19,3,327600,360000,32400,97
4,55,20,2,360000,375600,15600,587
4,55,22,2,376200,378000,1800,587
4,55,24,2,379200,385200,6000,587
4,55,26,2,385800,387600,1800,587
4,55,28,2,388200,392400,4200,587
4,55,30,2,393000,399300,6300,587
4,55,32,2,399960,400500,540,587
4,55,34,1,401100,446400,45300,715
5,55,35,1,446400,532800,86400,715
6,55,36,1,532800,604800,72000,715
0,56,0,1,0,29100,29100,719
0,56,2,2,31500,41820,10320,273
0,56,4,4,42060,45600,3540,437
0,56,6,2,45900,61200,15300,273
0,56,8,1,64500,65700,1200,719
0,56,10,7,66600,72000,5400,217
0,56,12,1,72900,100800,27900,719
1,56,13,1,100800,113400,12600,719
1,56,15,4,113700,115500,1800,594
1,56,17,4,115680,117900,2220,281
1,56,19,2,118800,124200,5400,273
1,56,21,3,126000,127200,1200,135
1,56,23,3,127680,129360,1680,9
1,56,25,4,129720,130080,360,305
1,56,27,2,130800,147600,16800,273
1,56,29,1,148200,187200,39000,719
2,56,30,1,187200,199800,12600,719
2,56,32,4,200100,201900,1800,536
2,56,34,4,202080,204300,2220,328
2,56,36,2,205200,210600,5400,273
2,56,38,3,212400,213600,1200,24
2,56,40,3,214080,215760,1680,1
2,56,42,4,216120,216480,360,605
2,56,44,2,217200,234000,16800,273
2,56,46,1,234600,273600,39000,719
3,56,47,1,273600,286200,12600,719
3,56,49,4,286500,288300,1800,410
3,56,51,4,288480,290700,2220,562
3,56,53,2,291600,297000,5400,273
3,56,55,3,298800,300000,1200,146
3,56,57,3,300480,302160,1680,242
3,56,59,4,302520,302880,360,473
3,56,61,2,303600,320400,16800,273
3,56,63,1,321000,360000,39000,719
4,56,64,1,360000,363600,3600,719
4,56,66,2,366300,382500,16200,273
4,56,68,1,385200,446400,61200,719
5,56,69,1,446400,532800,86400,719
6,56,70,1,532800,561600,28800,719
6,56,72,3,564300,567900,3600,5
6,56,74,3,568500,569400,900,215
6,56,76,3,570000,574200,4200,14
6,56,78,1,577200,604800,27600,719
0,57,0,1,0,24300,24300,703
0,57,2,2,26100,60300,34200,267
0,57,4,3,62100,66600,4500,246
0,57,6,1,67200,100800,33600,703
1,57,7,4,100800,187200,86400,387
2,57,8,4,187200,273600,86400,535
3,57,9,4,273600,360000,86400,415
4,57,10,4,360000,368100,8100,632
4,57,12,4,369000,372600,3600,631
4,57,14,1,372900,375300,2400,703
4,57,16,2,376500,389700,13200,267
4,57,18,4,390300,393000,2700,298
4,57,20,2,393900,409500,15600,267
4,57,22,3,410700,418500,7800,0
4,57,24,1,420000,446400,26400,703
5,57,25,4,446400,464220,17820,408
5,57,27,4,465360,473700,8340,368
5,57,29,3,474120,477120,3000,235
5,57,31,4,478320,479220,900,631
5,57,33,4,480000,507600,27600,587
5,57,35,4,508200,512100,3900,540
5,57,37,4,512700,532800,20100,624
6,57,38,1,532800,604800,72000,703
0,58,0,1,0,50370,50370,670
0,58,2,4,50490,56820,6330,631
0,58,4,2,57300,66660,9360,610
0,58,6,4,66840,68100,1260,588
0,58,8,2,68280,75900,7620,610
0,58,10,1,76440,100800,24360,670
1,58,11,1,100800,102840,2040,670
1,58,13,2,103080,103800,720,610
1,58,15,2,104460,107100,2640,610
1,58,17,1,108180,112800,4620,670
1,58,19,2,113160,151200,38040,610
1,58,21,2,151320,159300,7980,610
1,58,23,4,159660,163800,4140,455
1,58,25,1,163980,187200,23220,670
2,58,26,1,187200,189240,2040,670
2,58,28,2,189480,190200,720,610
2,58,30,2,190860,193500,2640,610
2,58,32,1,194580,199200,4620,670
2,58,34,2,199560,237600,38040,610
2,58,36,2,237720,245700,7980,610
2,58,38,4,246060,250200,4140,566
2,58,40,1,250380,273600,23220,670
3,58,41,1,273600,275640,2040,670
3,58,43,2,275880,276600,720,610
3,58,45,2,277260,279900,2640,610
3,58,47,1,280980,285600,4620,670
3,58,49,2,285960,324000,38040,610
3,58,51,2,324120,332100,7980,610
3,58,53,4,332460,336600,4140,570
3,58,55,1,336780,360000,23220,670
4,58,56,1,360000,376200,16200,670
4,58,58,2,377400,383400,6000,610
4,58,60,4,384300,387600,3300,445
4,58,62,4,388800,390600,1800,364
4,58,64,2,392400,408600,16200,610
4,58,66,4,410400,415800,5400,555
4,58,68,4,417600,446400,28800,552
5,58,69,1,446400,452700,6300,670
5,58,71,2,453600,493200,39600,610
5,58,73,3,494100,498600,4500,152
5,58,75,1,499500,532800,33300,670
6,58,76,1,532800,539100,6300,670
6,58,78,2,540000,573270,33270,610
6,58,80,4,573390,574200,810,366
6,58,82,1,575100,604800,29700,670
0,59,0,4,0,14400,14400,396
0,59,2,1,14520,31200,16680,653
0,59,4,5,31920,61380,29460,270
0,59,6,1,62100,100800,38700,653
1,59,7,1,100800,111960,11160,653
1,59,9,5,112620,136500,23880,270
1,59,11,1,137400,151860,14460,653
1,59,13,3,154200,156900,2700,138
1,59,15,1,159180,187200,28020,653
2,59,16,1,187200,198360,11160,653
2,59,18,5,199020,222900,23880,270
2,59,20,1,223800,238260,14460,653
2,59,22,3,240600,243300,2700,78
2,59,24,1,245580,273600,28020,653
3,59,25,1,273600,284760,11160,653
3,59,27,5,285420,309300,23880,270
3,59,29,1,310200,324660,14460,653
3,59,31,3,327000,329700,2700,251
3,59,33,1,331980,360000,28020,653
4,59,34,1,360000,374400,14400,653
4,59,36,5,376200,400500,24300,270
4,59,38,4,401400,405900,4500,524
4,59,40,1,406800,446400,39600,653
5,59,41,4,446400,532800,86400,310
6,59,42,1,532800,548520,15720,653
6,59,44,7,548700,556200,7500,30
6,59,46,1,556380,565020,8640,653
6,59,48,4,571380,578700,7320,348
6,59,50,4,579600,585000,5400,602
6,59,52,4,585900,604800,18900,455
0,60,0,1,0,22500,22500,693
0,60,2,4,22800,23400,600,368
0,60,4,1,23700,25200,1500,693
0,60,6,4,25620,26040,420,348
0,60,8,1,26700,28800,2100,693
0,60,10,4,29220,29640,420,411
0,60,12,1,30300,32400,2100,693
0,60,14,4,33300,37200,3900,455
0,60,16,4,38700,45000,6300,395
0,60,18,1,45900,53400,7500,693
0,60,20,4,53820,54780,960,307
0,60,22,1,55200,57600,2400,693
0,60,24,4,58500,59400,900,321
0,60,26,4,59700,60300,600,505
0,60,28,1,61800,100800,39000,693
1,60,29,1,100800,119700,18900,693
1,60,31,3,120120,121500,1380,82
1,60,33,4,122160,125940,3780,389
1,60,35,1,126300,187200,60900,693
2,60,36,1,187200,206100,18900,693
2,60,38,3,206520,207900,1380,184
2,60,40,4,208560,212340,3780,498
2,60,42,1,212700,273600,60900,693
3,60,43,1,273600,292500,18900,693
3,60,45,3,292920,294300,1380,213
3,60,47,4,294960,298740,3780,461
3,60,49,1,299100,360000,60900,693
4,60,50,1,360000,446400,86400,693
5,60,51,1,446400,464580,18180,693
5,60,53,4,470400,532800,62400,403
6,60,54,1,532800,549900,17100,693
6,60,56,1,551100,552600,1500,693
6,60,58,1,553500,560100,6600,693
6,60,60,4,560700,564000,3300,393
6,60,62,1,564600,604800,40200,693
0,61,0,1,0,41400,41400,716
0,61,2,4,42420,45540,3120,348
0,61,4,4,46260,47040,780,552
0,61,6,4,47580,54000,6420,275
0,61,8,1,54900,63000,8100,716
0,61,10,2,63900,82800,18900,350
0,61,12,1,83400,100800,17400,716
1,61,13,4,100800,187200,86400,455
2,61,14,4,187200,273600,86400,306
3,61,15,4,273600,360000,86400,491
4,61,16,1,360000,385170,25170,716
4,61,18,4,385290,387660,2370,423
4,61,20,4,387780,388080,300,563
4,61,22,3,388380,390600,2220,248
4,61,24,4,390900,391500,600,555
4,61,26,1,391800,412200,20400,716
4,61,28,4,414000,421200,7200,298
4,61,30,1,423000,446400,23400,716
5,61,31,1,446400,468000,21600,716
5,61,33,4,469380,477180,7800,516
5,61,35,1,479220,532800,53580,716
6,61,36,1,532800,568980,36180,716
6,61,38,4,569700,570600,900,589
6,61,40,1,571200,577080,5880,716
6,61,42,4,580500,586800,6300,540
6,61,44,4,588000,588600,600,343
6,61,46,3,589200,593940,4740,66
6,61,48,3,594180,596220,2040,101
6,61,50,1,600600,604800,4200,716
0,62,0,1,0,100800,100800,688
1,62,1,1,100800,113100,12300,688
1,62,3,2,113700,147600,33900,557
1,62,5,4,147900,151200,3300,365
1,62,7,1,151500,187200,35700,688
2,62,8,1,187200,199500,12300,688
2,62,10,2,200100,234000,33900,557
2,62,12,4,234300,237600,3300,580
2,62,14,1,237900,273600,35700,688
3,62,15,1,273600,285900,12300,688
3,62,17,2,286500,320400,33900,557
3,62,19,4,320700,324000,3300,366
3,62,21,1,324300,360000,35700,688
4,62,22,1,360000,374400,14400,688
4,62,24,2,375300,393300,18000,557
4,62,26,4,393900,394200,300,583
4,62,28,4,395400,402000,6600,409
4,62,30,1,403200,446400,43200,688
5,62,31,1,446400,468000,21600,688
5,62,33,4,468600,471600,3000,322
5,62,35,3,474300,477000,2700,106
5,62,37,1,477900,532800,54900,688
6,62,38,4,532800,545340,12540,455
6,62,40,1,549540,572400,22860,688
6,62,42,3,572700,576000,3300,234
6,62,44,1,576540,604800,28260,688
0,63,0,1,0,39600,39600,658
0,63,2,4,41400,42300,900,387
0,63,4,4,42900,43680,780,325
0,63,6,4,44280,44880,600,368
0,63,8,3,45060,45900,840,233
0,63,10,4,58140,58800,660,306
0,63,12,4,73680,100800,27120,322
1,63,13,1,100800,112500,11700,658
1,63,15,5,112680,140220,27540,269
1,63,17,4,140400,152880,12480,415
1,63,19,1,153060,187200,34140,658
2,63,20,1,187200,198900,11700,658
2,63,22,5,199080,226620,27540,269
2,63,24,4,226800,239280,12480,557
2,63,26,1,239460,273600,34140,658
3,63,27,1,273600,285300,11700,658
3,63,29,5,285480,313020,27540,269
3,63,31,4,313200,325680,12480,631
3,63,33,1,325860,360000,34140,658
4,63,34,1,360000,372600,12600,658
4,63,36,5,374400,400500,26100,269
4,63,38,4,401400,403800,2400,539
4,63,40,1,405300,446400,41100,658
5,63,41,1,446400,465000,18600,658
5,63,43,3,465420,468900,3480,125
5,63,45,1,469500,484200,14700,658
5,63,47,3,485100,489000,3900,132
5,63,49,1,489900,532800,42900,658
6,63,50,1,532800,579600,46800,658
6,63,52,3,580800,583200,2400,38
6,63,54,3,584400,587700,3300,159
6,63,56,1,588600,604800,16200,658
0,64,0,1,0,14400,14400,662
0,64,2,4,14520,100800,86280,380
1,64,3,1,100800,187200,86400,662
2,64,4,1,187200,273600,86400,662
3,64,5,1,273600,360000,86400,662
4,64,6,1,360000,374400,14400,662
4,64,8,2,376800,380400,3600,316
4,64,10,2,381600,388800,7200,316
4,64,12,2,390300,399600,9300,316
4,64,14,1,402420,407700,5280,662
4,64,16,4,408900,414600,5700,335
4,64,18,4,415680,446400,30720,618
5,64,19,1,446400,460800,14400,662
5,64,21,4,462600,466200,3600,568
5,64,23,4,467400,479700,12300,519
5,64,25,1,480600,486000,5400,662
5,64,27,3,487800,492300,4500,50
5,64,29,3,493500,495000,1500,47
5,64,31,1,496200,500400,4200,662
5,64,33,4,501000,501600,600,620
5,64,35,1,502200,532800,30600,662
6,64,36,1,532800,557400,24600,662
6,64,38,7,558000,563400,5400,197
6,64,40,3,563880,565440,1560,81
6,64,42,4,565920,571920,6000,283
6,64,44,4,572580,573300,720,349
6,64,46,3,573900,575880,1980,70
6,64,48,1,576780,604800,28020,662
0,65,0,1,0,34800,34800,711
0,65,2,2,36000,71100,35100,388
0,65,4,1,72300,100800,28500,711
1,65,5,1,100800,122400,21600,711
1,65,7,4,123000,123900,900,291
1,65,9,1,124500,127800,3300,711
1,65,11,2,129600,143100,13500,388
1,65,13,2,144000,150300,6300,388
1,65,15,1,151260,187200,35940,711
2,65,16,1,187200,208800,21600,711
2,65,18,4,209400,210300,900,306
2,65,20,1,210900,214200,3300,711
2,65,22,2,216000,229500,13500,388
2,65,24,2,230400,236700,6300,388
2,65,26,1,237660,273600,35940,711
3,65,27,1,273600,295200,21600,711
3,65,29,4,295800,296700,900,593
3,65,31,1,297300,300600,3300,711
3,65,33,2,302400,315900,13500,388
3,65,35,2,316800,323100,6300,388
3,65,37,1,324060,360000,35940,711
4,65,38,1,360000,369000,9000,711
4,65,40,2,370440,403200,32760,388
4,65,42,1,405000,414000,9000,711
4,65,44,3,414300,415800,1500,226
4,65,46,1,416100,446400,30300,711
5,65,47,1,446400,460200,13800,711
5,65,49,4,461700,468900,7200,563
5,65,51,3,469200,471600,2400,172
5,65,53,1,473400,496200,22800,711
5,65,55,4,496800,502200,5400,413
5,65,57,1,502800,532800,30000,711
6,65,58,1,532800,604800,72000,711
0,66,0,1,0,22500,22500,637
0,66,2,2,24300,69900,45600,619
0,66,4,4,71400,73500,2100,544
0,66,6,1,74280,100800,26520,637
1,66,7,1,100800,122760,21960,637
1,66,9,2,123960,135420,11460,619
1,66,11,4,136800,138840,2040,471
1,66,13,4,139440,142680,3240,358
1,66,15,1,143580,187200,43620,637
2,66,16,1,187200,209160,21960,637
2,66,18,2,210360,221820,11460,619
2,66,20,4,223200,225240,2040,360
2,66,22,4,225840,229080,3240,356
2,66,24,1,229980,273600,43620,637
3,66,25,1,273600,295560,21960,637
3,66,27,2,296760,308220,11460,619
3,66,29,4,309600,311640,2040,571
3,66,31,4,312240,315480,3240,362
3,66,33,1,316380,360000,43620,637
4,66,34,1,360000,402300,42300,637
4,66,36,2,403200,428700,25500,619
4,66,38,3,428880,429300,420,95
4,66,40,3,429420,429780,360,167
4,66,42,1,430620,446400,15780,637
5,66,43,1,446400,475200,28800,637
5,66,45,2,477060,477360,300,619
5,66,47,2,477900,515400,37500,619
5,66,49,1,517620,532800,15180,637
6,66,50,1,532800,604800,72000,637
0,67,0,1,0,63000,63000,645
0,67,2,4,65400,100800,35400,618
1,67,3,1,100800,125640,24840,645
1,67,5,3,125760,126060,300,164
1,67,7,4,127200,127740,540,283
1,67,9,3,128040,128760,720,161
1,67,11,4,129030,129330,300,495
1,67,13,4,130980,131340,360,407
1,67,15,4,131580,133860,2280,490
1,67,17,4,134100,134400,300,335
1,67,19,1,136020,154800,18780,645
1,67,21,4,155100,157800,2700,291
1,67,23,1,158100,187200,29100,645
2,67,24,1,187200,212040,24840,645
2,67,26,3,212160,212460,300,64
2,67,28,4,213600,214140,540,415
2,67,30,3,214440,215160,720,177
2,67,32,4,215430,215730,300,547
2,67,34,4,217380,217740,360,327
2,67,36,4,217980,220260,2280,353
2,67,38,4,220500,220800,300,326
2,67,40,1,222420,241200,18780,645
2,67,42,4,241500,244200,2700,294
2,67,44,1,244500,273600,29100,645
3,67,45,1,273600,298440,24840,645
3,67,47,3,298560,298860,300,171
3,67,49,4,300000,300540,540,348
3,67,51,3,300840,301560,720,23
3,67,53,4,301830,302130,300,509
3,67,55,4,303780,304140,360,449
3,67,57,4,304380,306660,2280,291
3,67,59,4,306900,307200,300,449
3,67,61,1,308820,327600,18780,645
3,67,63,4,327900,330600,2700,563
3,67,65,1,330900,360000,29100,645
4,67,66,1,360000,372600,12600,645
4,67,68,5,372900,408660,35760,262
4,67,70,1,408960,446400,37440,645
5,67,71,1,446400,483600,37200,645
5,67,73,3,484980,485700,720,22
5,67,75,1,486600,532800,46200,645
6,67,76,1,532800,555600,22800,645
6,67,78,7,555780,565620,9840,92
6,67,80,1,565800,604800,39000,645
0,68,0,1,0,34200,34200,696
0,68,2,2,35580,64080,28500,286
0,68,4,1,65820,100800,34980,696
1,68,5,1,100800,112500,11700,696
1,68,7,2,114600,129900,15300,286
1,68,9,4,130200,130500,300,283
1,68,11,2,130800,146100,15300,286
1,68,13,4,146700,147000,300,622
1,68,15,3,147120,150300,3180,62
1,68,17,1,153600,187200,33600,696
2,68,18,1,187200,198900,11700,696
2,68,20,2,201000,216300,15300,286
2,68,22,4,216600,216900,300,596
2,68,24,2,217200,232500,15300,286
2,68,26,4,233100,233400,300,374
2,68,28,3,233520,236700,3180,65
2,68,30,1,240000,273600,33600,696
3,68,31,1,273600,285300,11700,696
3,68,33,2,287400,302700,15300,286
3,68,35,4,303000,303300,300,620
3,68,37,2,303600,318900,15300,286
3,68,39,4,319500,319800,300,391
3,68,41,3,319920,323100,3180,156
3,68,43,1,326400,360000,33600,696
4,68,44,1,360000,373500,13500,696
4,68,46,2,374100,407220,33120,286
4,68,48,1,408120,446400,38280,696
5,68,49,1,446400,487500,41100,696
5,68,51,2,487680,510240,22560,286
5,68,53,1,510540,532800,22260,696
6,68,54,1,532800,556200,23400,696
6,68,56,7,556620,561900,5280,74
6,68,58,1,562320,564300,1980,696
6,68,60,2,564540,584400,19860,286
6,68,62,1,584640,585300,660,696
6,68,64,4,585900,586500,600,567
6,68,66,1,587100,604800,17700,696
0,69,0,1,0,21600,21600,729
0,69,2,2,22500,68400,45900,331
0,69,4,1,69300,100800,31500,729
1,69,5,1,100800,109800,9000,729
1,69,7,4,110700,111000,300,324
1,69,9,2,112200,140400,28200,331
1,69,11,4,141300,145800,4500,423
1,69,13,4,146700,147000,300,308
1,69,15,1,147900,187200,39300,729
2,69,16,1,187200,196200,9000,729
2,69,18,4,197100,197400,300,308
2,69,20,2,198600,226800,28200,331
2,69,22,4,227700,232200,4500,385
2,69,24,4,233100,233400,300,477
2,69,26,1,234300,273600,39300,729
3,69,27,1,273600,282600,9000,729
3,69,29,4,283500,283800,300,415
3,69,31,2,285000,313200,28200,331
3,69,33,4,314100,318600,4500,371
3,69,35,4,319500,319800,300,413
3,69,37,1,320700,360000,39300,729
4,69,38,1,360000,372060,12060,729
4,69,40,4,372300,372660,360,585
4,69,42,2,372960,375000,2040,331
4,69,44,2,375240,382500,7260,331
4,69,46,2,382740,386100,3360,331
4,69,48,2,386400,390900,4500,331
4,69,50,2,391080,393300,2220,331
4,69,52,4,393720,395460,1740,611
4,69,54,2,395880,407760,11880,331
4,69,56,1,408180,412920,4740,729
4,69,58,2,413520,424200,10680,331
4,69,60,4,424500,424920,420,387
4,69,62,1,425280,446400,21120,729
5,69,63,1,446400,467400,21000,729
5,69,65,3,468000,469500,1500,218
5,69,67,3,469800,470100,300,180
5,69,69,1,470280,513900,43620,729
5,69,71,4,514800,525600,10800,491
6,69,73,1,526500,532800,6300,729
6,69,74,1,532800,604800,72000,729
0,70,0,1,0,29700,29700,674
0,70,2,2,31800,51000,19200,324
0,70,4,4,51300,54900,3600,618
0,70,6,2,55200,75300,20100,324
0,70,8,1,77100,100800,23700,674
1,70,9,4,100800,114360,13560,396
1,70,11,4,123300,140400,17100,631
1,70,13,4,144060,153960,9900,477
1,70,15,4,155100,157560,2460,368
1,70,17,1,162060,187200,25140,674
2,70,18,4,187200,200760,13560,163
2,70,20,4,209700,226800,17100,513
2,70,22,4,230460,240360,9900,343
2,70,24,4,241500,243960,2460,343
2,70,26,1,248460,273600,25140,674
3,70,27,4,273600,287160,13560,527
3,70,29,4,296100,313200,17100,415
3,70,31,4,316860,326760,9900,559
3,70,33,4,327900,330360,2460,452
3,70,35,1,334860,360000,25140,674
4,70,36,1,360000,446400,86400,674
5,70,37,1,446400,480600,34200,674
5,70,39,3,481500,484200,2700,156
5,70,41,3,484500,495300,10800,25
5,70,43,1,495900,504900,9000,674
5,70,45,4,505800,517500,11700,275
6,70,47,1,518700,532800,14100,674
6,70,48,1,532800,550800,18000,674
6,70,50,7,552600,565200,12600,195
6,70,52,4,566100,590400,24300,528
6,70,54,1,592200,604800,12600,674
0,71,0,1,0,28200,28200,709
0,71,2,2,28800,66600,37800,383
0,71,4,1,67080,100800,33720,709
1,71,5,1,100800,118800,18000,709
1,71,7,1,119700,134760,15060,709
1,71,9,1,135360,137700,2340,709
1,71,11,4,139200,142500,3300,341
1,71,13,4,143400,144300,900,405
1,71,15,1,145200,150000,4800,709
1,71,17,4,150900,154800,3900,587
1,71,19,4,155700,156600,900,549
1,71,21,1,157500,187200,29700,709
2,71,22,1,187200,205200,18000,709
2,71,24,1,206100,221160,15060,709
2,71,26,1,221760,224100,2340,709
2,71,28,4,225600,228900,3300,402
2,71,30,4,229800,230700,900,365
2,71,32,1,231600,236400,4800,709
2,71,34,4,237300,241200,3900,387
2,71,36,4,242100,243000,900,400
2,71,38,1,243900,273600,29700,709
3,71,39,1,273600,291600,18000,709
3,71,41,1,292500,307560,15060,709
3,71,43,1,308160,310500,2340,709
3,71,45,4,312000,315300,3300,460
3,71,47,4,316200,317100,900,556
3,71,49,1,318000,322800,4800,709
3,71,51,4,323700,327600,3900,368
3,71,53,4,328500,329400,900,507
3,71,55,1,330300,360000,29700,709
4,71,56,1,360000,446400,86400,709
5,71,57,1,446400,463500,17100,709
5,71,59,4,472500,477000,4500,297
5,71,61,4,477900,481500,3600,535
5,71,63,4,482100,483300,1200,607
5,71,65,4,484200,493200,9000,343
5,71,67,3,493800,495000,1200,56
5,71,69,4,495600,502200,6600,584
5,71,71,4,503100,505800,2700,475
5,71,73,1,506400,532800,26400,709
6,71,74,1,532800,556800,24000,709
6,71,76,7,557700,561000,3300,199
6,71,78,3,561660,563640,1980,10
6,71,80,1,564000,575700,11700,709
6,71,82,3,576840,582000,5160,253
6,71,84,3,582120,582900,780,169
6,71,86,1,583980,585000,1020,709
6,71,88,1,588120,604800,16680,709
0,72,0,1,0,44880,44880,686
0,72,2,4,45090,45390,300,309
0,72,4,1,45660,72300,26640,686
0,72,6,4,72600,75300,2700,571
0,72,8,1,75600,100800,25200,686
1,72,9,1,100800,117000,16200,686
1,72,11,1,117900,142200,24300,686
1,72,13,1,144300,149400,5100,686
1,72,15,1,150300,162000,11700,686
1,72,17,1,162600,187200,24600,686
2,72,18,1,187200,203400,16200,686
2,72,20,1,204300,228600,24300,686
2,72,22,1,230700,235800,5100,686
2,72,24,1,236700,248400,11700,686
2,72,26,1,249000,273600,24600,686
3,72,27,1,273600,289800,16200,686
3,72,29,1,290700,315000,24300,686
3,72,31,1,317100,322200,5100,686
3,72,33,1,323100,334800,11700,686
3,72,35,1,335400,360000,24600,686
4,72,36,1,360000,369000,9000,686
4,72,38,2,370800,403200,32400,334
4,72,40,1,405000,412200,7200,686
4,72,42,3,412500,413100,600,157
4,72,44,1,413400,446400,33000,686
5,72,45,1,446400,457200,10800,686
5,72,47,4,463500,464400,900,359
5,72,49,4,471600,491400,19800,421
5,72,51,1,491700,496800,5100,686
5,72,53,4,498600,502200,3600,568
5,72,55,1,504000,532800,28800,686
6,72,56,1,532800,559800,27000,686
6,72,58,4,560700,563400,2700,368
6,72,60,3,564000,564600,600,214
6,72,62,1,565200,568800,3600,686
6,72,64,3,569700,572400,2700,134
6,72,66,1,573300,604800,31500,686
0,73,0,1,0,100800,100800,651
1,73,1,4,100800,124200,23400,468
1,73,3,3,129000,130080,1080,244
1,73,5,4,134100,135300,1200,568
1,73,7,4,137460,140400,2940,480
1,73,9,4,149400,151920,2520,617
1,73,11,1,153900,187200,33300,651
2,73,12,4,187200,210600,23400,378
2,73,14,3,215400,216480,1080,67
2,73,16,4,220500,221700,1200,634
2,73,18,4,223860,226800,2940,619
2,73,20,4,235800,238320,2520,447
2,73,22,1,240300,273600,33300,651
3,73,23,4,273600,297000,23400,456
3,73,25,3,301800,302880,1080,174
3,73,27,4,306900,308100,1200,420
3,73,29,4,310260,313200,2940,403
3,73,31,4,322200,324720,2520,440
3,73,33,1,326700,360000,33300,651
4,73,34,1,360000,446400,86400,651
5,73,35,1,446400,468000,21600,651
5,73,37,3,468900,470700,1800,57
5,73,39,3,471600,471900,300,52
5,73,41,1,472500,477000,4500,651
5,73,43,2,478200,509700,31500,369
5,73,45,1,511200,532800,21600,651
6,73,46,1,532800,545400,12600,651
6,73,48,7,546300,568500,22200,202
6,73,50,3,569100,570000,900,2
6,73,52,1,570900,604800,33900,651
0,74,0,1,0,18900,18900,734
0,74,2,2,20400,59400,39000,106
0,74,4,4,60600,62700,2100,604
0,74,6,1,64500,100800,36300,734
1,74,7,1,100800,108000,7200,734
1,74,9,1,109200,112320,3120,734
1,74,11,2,115500,164520,49020,106
1,74,13,1,166860,187200,20340,734
2,74,14,1,187200,194400,7200,734
2,74,16,1,195600,198720,3120,734
2,74,18,2,201900,250920,49020,106
2,74,20,1,253260,273600,20340,734
3,74,21,1,273600,280800,7200,734
3,74,23,1,282000,285120,3120,734
3,74,25,2,288300,337320,49020,106
3,74,27,1,339660,360000,20340,734
4,74,28,1,360000,379800,19800,734
4,74,32,1,386400,446400,60000,734
5,74,33,1,446400,483300,36900,734
5,74,35,7,484200,502800,18600,30
5,74,37,1,503700,532800,29100,734
6,74,38,2,532800,557400,24600,106
6,74,40,2,557760,597600,39840,106
6,74,42,1,598200,604800,6600,734
0,75,0,1,0,25200,25200,730
0,75,2,5,27000,61200,34200,262
0,75,4,1,63000,66000,3000,730
0,75,6,4,66300,70200,3900,587
0,75,8,1,70500,100800,30300,730
1,75,9,1,100800,117000,16200,730
1,75,11,4,118500,131400,12900,317
1,75,13,4,131700,133200,1500,587
1,75,15,3,134100,138600,4500,134
1,75,17,1,139800,152970,13170,730
1,75,19,3,153090,154770,1680,238
1,75,21,1,154890,187200,32310,730
2,75,22,1,187200,203400,16200,730
2,75,24,4,204900,217800,12900,304
2,75,26,4,218100,219600,1500,322
2,75,28,3,220500,225000,4500,229
2,75,30,1,226200,239370,13170,730
2,75,32,3,239490,241170,1680,213
2,75,34,1,241290,273600,32310,730
3,75,35,1,273600,289800,16200,730
3,75,37,4,291300,304200,12900,455
3,75,39,4,304500,306000,1500,524
3,75,41,3,306900,311400,4500,237
3,75,43,1,312600,325770,13170,730
3,75,45,3,325890,327570,1680,238
3,75,47,1,327690,360000,32310,730
4,75,48,1,360000,399600,39600,730
4,75,50,1,399900,409800,9900,730
4,75,52,1,410100,446400,36300,730
5,75,53,4,446400,460800,14400,424
5,75,55,4,462000,463500,1500,515
5,75,57,1,464400,478800,14400,730
5,75,59,3,480000,481200,1200,77
5,75,61,4,482100,532800,50700,304
6,75,62,1,532800,604800,72000,730
0,76,0,1,0,14400,14400,668
0,76,2,2,14520,59400,44880,309
0,76,4,3,60600,61020,420,95
0,76,6,4,61320,61620,300,396
0,76,8,1,63060,70260,7200,668
0,76,10,1,72660,100800,28140,668
1,76,11,4,100800,120000,19200,601
1,76,13,3,120900,121800,900,58
1,76,15,1,122400,153000,30600,668
1,76,17,7,154200,162600,8400,89
1,76,19,4,163200,165600,2400,369
1,76,21,1,166500,187200,20700,668
2,76,22,4,187200,206400,19200,433
2,76,24,3,207300,208200,900,241
2,76,26,1,208800,239400,30600,668
2,76,28,7,240600,249000,8400,89
2,76,30,4,249600,252000,2400,330
2,76,32,1,252900,273600,20700,668
3,76,33,4,273600,292800,19200,346
3,76,35,3,293700,294600,900,129
3,76,37,1,295200,325800,30600,668
3,76,39,7,327000,335400,8400,89
3,76,41,4,336000,338400,2400,488
3,76,43,1,339300,360000,20700,668
4,76,44,2,360000,371700,11700,309
4,76,46,2,372600,406800,34200,309
4,76,48,1,408000,409500,1500,668
4,76,50,3,410400,415800,5400,225
4,76,52,1,416700,419400,2700,668
4,76,54,4,423000,426600,3600,380
5,76,56,1,433800,446400,12600,668
5,76,59,4,465000,473400,8400,567
5,76,61,4,477000,480600,3600,289
5,76,63,4,486000,496800,10800,377
5,76,65,4,499500,500400,900,296
5,76,67,3,500760,501300,540,183
5,76,69,4,506760,508800,2040,377
5,76,71,4,510600,513360,2760,477
5,76,73,1,514800,532800,18000,668
6,76,74,1,532800,581400,48600,668
6,76,76,3,581820,582300,480,105
6,76,78,4,582600,583380,780,485
6,76,80,4,588600,589320,720,484
6,76,82,1,602280,604800,2520,668
0,77,0,1,0,29400,29400,673
0,77,2,5,30000,63600,33600,271
0,77,4,1,64200,100800,36600,673
1,77,5,1,100800,113520,12720,673
1,77,7,5,114060,136020,21960,271
1,77,9,5,137040,149160,12120,271
1,77,11,1,150660,187200,36540,673
2,77,12,1,187200,199920,12720,673
2,77,14,5,200460,222420,21960,271
2,77,16,5,223440,235560,12120,271
2,77,18,1,237060,273600,36540,673
3,77,19,1,273600,286320,12720,673
3,77,21,5,286860,308820,21960,271
3,77,23,5,309840,321960,12120,271
3,77,25,1,323460,360000,36540,673
4,77,26,1,360000,372000,12000,673
4,77,28,5,372300,406800,34500,271
4,77,30,4,407700,446400,38700,415
5,77,31,1,446400,478800,32400,673
5,77,33,3,479100,480300,1200,4
5,77,35,4,482700,489600,6900,587
5,77,37,1,492600,494100,1500,673
5,77,39,4,494400,504000,9600,318
5,77,41,1,504300,532800,28500,673
6,77,42,1,532800,555300,22500,673
6,77,44,1,555480,559800,4320,673
6,77,46,1,560220,580080,19860,673
6,77,48,4,580500,585900,5400,587
6,77,50,1,586260,604800,18540,673
0,78,0,4,0,14400,14400,322
0,78,2,1,14520,30600,16080,679
0,78,4,4,31500,36000,4500,615
0,78,6,3,36900,39600,2700,139
0,78,8,1,40500,63000,22500,679
0,78,10,4,63900,72000,8100,397
0,78,12,1,72900,100800,27900,679
1,78,13,1,100800,187200,86400,679
2,78,14,1,187200,273600,86400,679
3,78,15,1,273600,360000,86400,679
4,78,16,1,360000,401400,41400,679
4,78,18,4,402300,402600,300,308
4,78,20,4,402900,403200,300,570
4,78,22,1,404100,446400,42300,679
5,78,23,1,446400,486000,39600,679
5,78,25,4,486300,488100,1800,389
5,78,27,4,489600,498600,9000,308
5,78,29,1,499920,532800,32880,679
6,78,30,4,532800,604800,72000,466
0,79,0,1,0,44100,44100,702
0,79,2,3,44400,46200,1800,87
0,79,4,4,46500,100800,54300,455
1,79,5,1,100800,122400,21600,702
1,79,7,4,123000,123600,600,420
1,79,9,3,124200,125100,900,236
1,79,11,4,125400,128400,3000,301
1,79,13,4,129000,130500,1500,544
1,79,15,3,131400,133500,2100,98
1,79,17,3,134640,138300,3660,143
1,79,19,3,139200,144300,5100,125
1,79,21,4,144600,149400,4800,291
1,79,23,1,150600,187200,36600,702
2,79,24,1,187200,208800,21600,702
2,79,26,4,209400,210000,600,311
2,79,28,3,210600,211500,900,102
2,79,30,4,211800,214800,3000,368
2,79,32,4,215400,216900,1500,515
2,79,34,3,217800,219900,2100,72
2,79,36,3,221040,224700,3660,107
2,79,38,3,225600,230700,5100,54
2,79,40,4,231000,235800,4800,472
2,79,42,1,237000,273600,36600,702
3,79,43,1,273600,295200,21600,702
3,79,45,4,295800,296400,600,343
3,79,47,3,297000,297900,900,134
3,79,49,4,298200,301200,3000,326
3,79,51,4,301800,303300,1500,620
3,79,53,3,304200,306300,2100,3
3,79,55,3,307440,311100,3660,134
3,79,57,3,312000,317100,5100,6
3,79,59,4,317400,322200,4800,365
3,79,61,1,323400,360000,36600,702
4,79,62,1,360000,390600,30600,702
4,79,64,4,390900,394200,3300,455
4,79,66,1,394500,399600,5100,702
4,79,68,3,400500,403200,2700,175
4,79,70,1,404100,446400,42300,702
5,79,71,1,446400,462600,16200,702
5,79,73,3,463320,464820,1500,187
5,79,75,4,465660,466020,360,345
5,79,77,3,466500,467220,720,231
5,79,79,1,468300,500400,32100,702
5,79,81,1,502500,532800,30300,702
6,79,82,1,532800,579600,46800,702
6,79,84,1,582000,592200,10200,702
6,79,86,1,594000,604800,10800,702
0,80,0,4,0,14400,14400,515
0,80,2,1,14520,30600,16080,639
0,80,4,4,30900,33900,3000,439
0,80,6,3,34080,34800,720,34
0,80,8,3,36000,46200,10200,224
0,80,10,4,46500,52200,5700,549
0,80,12,4,54000,54600,600,518
0,80,14,1,55200,100800,45600,639
1,80,15,1,100800,117000,16200,639
1,80,17,4,118800,122100,3300,568
1,80,19,4,122700,123000,300,355
1,80,21,4,123300,123900,600,620
1,80,23,4,125400,125700,300,530
1,80,25,3,126300,127800,1500,227
1,80,27,3,128700,129300,600,245
1,80,29,1,130200,187200,57000,639
2,80,30,1,187200,203400,16200,639
2,80,32,4,205200,208500,3300,455
2,80,34,4,209100,209400,300,618
2,80,36,4,209700,210300,600,609
2,80,38,4,211800,212100,300,618
2,80,40,3,212700,214200,1500,55
2,80,42,3,215100,215700,600,55
2,80,44,1,216600,273600,57000,639
3,80,45,1,273600,289800,16200,639
3,80,47,4,291600,294900,3300,308
3,80,49,4,295500,295800,300,417
3,80,51,4,296100,296700,600,631
3,80,53,4,298200,298500,300,308
3,80,55,3,299100,300600,1500,234
3,80,57,3,301500,302100,600,41
3,80,59,1,303000,360000,57000,639
4,80,60,1,360000,446400,86400,639
5,80,61,1,446400,463680,17280,639
5,80,63,7,463800,471600,7800,193
5,80,65,1,471720,532800,61080,639
6,80,66,4,532800,604800,72000,372
0,81,0,1,0,100800,100800,717
1,81,1,1,100800,122400,21600,717
1,81,3,4,122700,128700,6000,631
1,81,5,1,129000,133200,4200,717
1,81,7,4,135000,138000,3000,355
1,81,9,4,138600,139500,900,366
1,81,11,4,139800,145800,6000,572
1,81,13,1,147600,153000,5400,717
1,81,15,4,154800,156600,1800,348
1,81,17,1,156720,187200,30480,717
2,81,18,1,187200,208800,21600,717
2,81,20,4,209100,215100,6000,565
2,81,22,1,215400,219600,4200,717
2,81,24,4,221400,224400,3000,332
2,81,26,4,225000,225900,900,322
2,81,28,4,226200,232200,6000,620
2,81,30,1,234000,239400,5400,717
2,81,32,4,241200,243000,1800,343
2,81,34,1,243120,273600,30480,717
3,81,35,1,273600,295200,21600,717
3,81,37,4,295500,301500,6000,365
3,81,39,1,301800,306000,4200,717
3,81,41,4,307800,310800,3000,291
3,81,43,4,311400,312300,900,291
3,81,45,4,312600,318600,6000,618
3,81,47,1,320400,325800,5400,717
3,81,49,4,327600,329400,1800,306
3,81,51,1,329520,360000,30480,717
4,81,52,1,360000,446400,86400,717
5,81,53,1,446400,472440,26040,717
5,81,55,3,472800,478200,5400,8
5,81,57,1,478560,490080,11520,717
5,81,59,3,490860,492900,2040,80
5,81,61,4,494100,495720,1620,427
5,81,63,1,496140,532800,36660,717
6,81,64,1,532800,551400,18600,717
6,81,66,7,552000,564000,12000,198
6,81,68,4,568800,582360,13560,568
6,81,70,1,585420,604800,19380,717
0,82,0,1,0,37800,37800,685
0,82,2,2,39600,72000,32400,137
0,82,4,3,73800,74700,900,138
0,82,6,1,75600,100800,25200,685
1,82,7,1,100800,154140,53340,685
1,82,9,4,158400,187200,28800,277
2,82,10,1,187200,240540,53340,685
2,82,12,4,244800,273600,28800,567
3,82,13,1,273600,326940,53340,685
3,82,15,4,331200,360000,28800,492
4,82,16,1,360000,371400,11400,685
4,82,18,2,372000,406800,34800,137
4,82,20,1,407460,446400,38940,685
5,82,21,1,446400,464700,18300,685
5,82,23,4,469020,472800,3780,399
5,82,25,4,473700,474300,600,499
5,82,27,3,478260,478680,420,119
5,82,29,4,479100,487800,8700,469
5,82,31,1,489600,493200,3600,685
5,82,33,4,494100,498300,4200,367
5,82,35,3,498600,501900,3300,39
5,82,37,1,503100,532800,29700,685
6,82,38,1,532800,554400,21600,685
6,82,40,3,555300,557100,1800,51
6,82,42,3,557400,558900,1500,208
6,82,44,3,559500,560400,900,212
6,82,46,3,560700,563400,2700,257
6,82,48,1,563700,567000,3300,685
6,82,50,4,567600,568800,1200,303
6,82,52,1,569400,604800,35400,685
0,83,0,1,0,25200,25200,723
0,83,2,2,26100,29700,3600,286
0,83,4,2,30600,61200,30600,286
0,83,6,1,62400,100800,38400,723
1,83,7,1,100800,108000,7200,723
1,83,9,1,109500,124200,14700,723
1,83,11,2,125460,127500,2040,286
1,83,13,4,128100,131700,3600,435
1,83,15,2,132540,138900,6360,286
1,83,17,1,139980,187200,47220,723
2,83,18,1,187200,194400,7200,723
2,83,20,1,195900,210600,14700,723
2,83,22,2,211860,213900,2040,286
2,83,24,4,214500,218100,3600,396
2,83,26,2,218940,225300,6360,286
2,83,28,1,226380,273600,47220,723
3,83,29,1,273600,280800,7200,723
3,83,31,1,282300,297000,14700,723
3,83,33,2,298260,300300,2040,286
3,83,35,4,300900,304500,3600,508
3,83,37,2,305340,311700,6360,286
3,83,39,1,312780,360000,47220,723
4,83,40,1,360000,374400,14400,723
4,83,42,4,376140,376440,300,587
4,83,44,4,376680,380700,4020,634
4,83,46,4,381720,382500,780,332
4,83,48,2,383400,384600,1200,286
4,83,50,3,384900,388680,3780,16
4,83,52,4,389400,390600,1200,342
4,83,54,4,391500,392400,900,396
4,83,56,1,393300,399300,6000,723
4,83,58,4,400200,400800,600,492
4,83,60,4,401640,401940,300,492
4,83,62,1,402660,446400,43740,723
5,83,63,1,446400,481800,35400,723
5,83,65,2,482100,511500,29400,286
5,83,67,1,511800,532800,21000,723
6,83,68,1,532800,559800,27000,723
6,83,70,3,561600,564300,2700,87
6,83,72,1,565200,604800,39600,723
0,84,0,1,0,27000,27000,705
0,84,2,2,28800,36000,7200,618
0,84,4,4,36300,37200,900,361
0,84,6,2,50400,54000,3600,618
0,84,8,4,54900,56700,1800,456
0,84,10,4,57600,58500,900,386
0,84,12,2,59100,72000,12900,618
0,84,14,4,72600,73200,600,587
0,84,16,1,73800,100800,27000,705
1,84,17,1,100800,115200,14400,705
1,84,19,2,117000,157500,40500,618
1,84,21,1,159000,187200,28200,705
2,84,22,1,187200,201600,14400,705
2,84,24,2,203400,243900,40500,618
2,84,26,1,245400,273600,28200,705
3,84,27,1,273600,288000,14400,705
3,84,29,2,289800,330300,40500,618
3,84,31,1,331800,360000,28200,705
4,84,32,1,360000,378900,18900,705
4,84,34,4,385200,405000,19800,322
4,84,36,7,409500,411300,1800,200
4,84,38,1,411600,446400,34800,705
5,84,39,1,446400,460800,14400,705
5,84,41,1,462000,462900,900,705
5,84,43,3,465300,467100,1800,151
5,84,45,1,468900,532800,63900,705
6,84,46,1,532800,604800,72000,705
0,85,0,4,0,14400,14400,558
0,85,2,1,14520,18300,3780,663
0,85,4,2,18600,19200,600,497
0,85,6,2,23700,57600,33900,497
0,85,8,1,63600,65700,2100,663
0,85,10,4,66600,71100,4500,464
0,85,12,1,71700,100800,29100,663
1,85,13,1,100800,108900,8100,663
1,85,15,4,109800,110100,300,564
1,85,17,3,110400,111300,900,252
1,85,19,1,112500,118800,6300,663
1,85,21,2,119700,127800,8100,497
1,85,23,4,129000,134100,5100,400
1,85,25,4,135000,138000,3000,477
1,85,27,1,138900,140100,1200,663
1,85,29,4,141300,142800,1500,459
1,85,31,4,144000,150000,6000,343
1,85,33,1,151200,187200,36000,663
2,85,34,1,187200,195300,8100,663
2,85,36,4,196200,196500,300,552
2,85,38,3,196800,197700,900,75
2,85,40,1,198900,205200,6300,663
2,85,42,2,206100,214200,8100,497
2,85,44,4,215400,220500,5100,343
2,85,46,4,221400,224400,3000,368
2,85,48,1,225300,226500,1200,663
2,85,50,4,227700,229200,1500,291
2,85,52,4,230400,236400,6000,362
2,85,54,1,237600,273600,36000,663
3,85,55,1,273600,281700,8100,663
3,85,57,4,282600,282900,300,500
3,85,59,3,283200,284100,900,132
3,85,61,1,285300,291600,6300,663
3,85,63,2,292500,300600,8100,497
3,85,65,4,301800,306900,5100,526
3,85,67,4,307800,310800,3000,299
3,85,69,1,311700,312900,1200,663
3,85,71,4,314100,315600,1500,556
3,85,73,4,316800,322800,6000,528
3,85,75,1,324000,360000,36000,663
4,85,76,1,360000,380640,20640,663
4,85,78,2,381300,390900,9600,497
4,85,80,4,391560,396000,4440,298
4,85,82,2,396300,424800,28500,497
4,85,84,1,425640,426660,1020,663
4,85,86,4,428160,433200,5040,415
5,85,88,1,434760,446400,11640,663
5,85,89,1,446400,461400,15000,663
5,85,91,2,462000,464400,2400,497
5,85,93,2,465300,501900,36600,497
5,85,95,1,502800,532800,30000,663
6,85,96,4,532800,604800,72000,277
0,86,0,1,0,28800,28800,644
0,86,2,4,32400,100800,68400,335
1,86,3,1,100800,115200,14400,644
1,86,5,2,115500,124200,8700,512
1,86,7,1,126000,126300,300,644
1,86,9,4,127200,129600,2400,552
1,86,11,3,131400,131700,300,220
1,86,13,4,131820,133200,1380,315
1,86,15,2,134100,138600,4500,512
1,86,17,3,139800,141300,1500,72
1,86,19,2,142500,147600,5100,512
1,86,21,3,148500,149400,900,17
1,86,23,4,150000,150300,300,520
1,86,25,1,151200,187200,36000,644
2,86,26,1,187200,201600,14400,644
2,86,28,2,201900,210600,8700,512
2,86,30,1,212400,212700,300,644
2,86,32,4,213600,216000,2400,622
2,86,34,3,217800,218100,300,243
2,86,36,4,218220,219600,1380,503
2,86,38,2,220500,225000,4500,512
2,86,40,3,226200,227700,1500,4
2,86,42,2,228900,234000,5100,512
2,86,44,3,234900,235800,900,173
2,86,46,4,236400,236700,300,493
2,86,48,1,237600,273600,36000,644
3,86,49,1,273600,288000,14400,644
3,86,51,2,288300,297000,8700,512
3,86,53,1,298800,299100,300,644
3,86,55,4,300000,302400,2400,597
3,86,57,3,304200,304500,300,109
3,86,59,4,304620,306000,1380,334
3,86,61,2,306900,311400,4500,512
3,86,63,3,312600,314100,1500,183
3,86,65,2,315300,320400,5100,512
3,86,67,3,321300,322200,900,160
3,86,69,4,322800,323100,300,335
3,86,71,1,324000,360000,36000,644
4,86,72,1,360000,369000,9000,644
4,86,74,2,369720,404760,35040,512
4,86,76,4,405000,405300,300,280
4,86,78,4,405420,406140,720,286
4,86,80,1,407040,446400,39360,644
5,86,81,1,446400,493200,46800,644
5,86,83,2,494400,498600,4200,512
5,86,85,1,502200,532800,30600,644
6,86,86,4,532800,551100,18300,298
6,86,88,3,556200,557100,900,145
6,86,90,4,558000,565200,7200,618
6,86,92,4,583680,586800,3120,546
6,86,94,1,589500,604800,15300,644
0,87,0,1,0,38400,38400,646
0,87,2,4,41400,44100,2700,350
0,87,4,1,50100,66600,16500,646
0,87,6,4,68400,77400,9000,631
0,87,8,1,79200,100800,21600,646
1,87,9,1,100800,118800,18000,646
1,87,11,3,119400,121200,1800,187
1,87,13,1,121800,187200,65400,646
2,87,14,1,187200,205200,18000,646
2,87,16,3,205800,207600,1800,223
2,87,18,1,208200,273600,65400,646
3,87,19,1,273600,291600,18000,646
3,87,21,3,292200,294000,1800,154
3,87,23,1,294600,360000,65400,646
4,87,24,1,360000,412620,52620,646
4,87,26,4,416520,424860,8340,337
4,87,28,1,428760,446400,17640,646
5,87,29,1,446400,493200,46800,646
5,87,31,4,494100,516600,22500,524
6,87,33,1,518400,532800,14400,646
6,87,34,1,532800,555000,22200,646
6,87,36,7,556260,561720,5460,31
6,87,38,4,563400,567600,4200,566
6,87,40,4,568200,573000,4800,455
6,87,42,3,573600,576300,2700,44
6,87,44,3,576600,577740,1140,26
6,87,46,1,580560,604800,24240,646
0,88,0,1,0,34200,34200,725
0,88,2,3,34500,34800,300,105
0,88,4,6,36000,45000,9000,259
0,88,6,4,45900,48600,2700,278
0,88,8,1,49800,100800,51000,725
1,88,9,1,100800,114600,13800,725
1,88,11,4,115200,116100,900,455
1,88,13,1,116700,129000,12300,725
1,88,15,4,129600,130200,600,554
1,88,17,4,130800,136800,6000,433
1,88,19,4,137400,138300,900,533
1,88,21,4,138900,187200,48300,540
2,88,22,1,187200,201000,13800,725
2,88,24,4,201600,202500,900,387
2,88,26,1,203100,215400,12300,725
2,88,28,4,216000,216600,600,428
2,88,30,4,217200,223200,6000,433
2,88,32,4,223800,224700,900,295
2,88,34,4,225300,273600,48300,323
3,88,35,1,273600,287400,13800,725
3,88,37,4,288000,288900,900,534
3,88,39,1,289500,301800,12300,725
3,88,41,4,302400,303000,600,303
3,88,43,4,303600,309600,6000,287
3,88,45,4,310200,311100,900,392
3,88,47,4,311700,360000,48300,474
4,88,48,1,360000,446400,86400,725
5,88,49,1,446400,532800,86400,725
6,88,50,1,532800,577800,45000,725
6,88,52,3,578220,579300,1080,180
6,88,54,1,580500,588000,7500,725
6,88,56,4,588600,595200,6600,368
6,88,58,1,595800,604800,9000,725
0,89,0,1,0,32400,32400,666
0,89,2,1,34200,39600,5400,666
0,89,4,1,42300,100800,58500,666
1,89,5,1,100800,135600,34800,666
1,89,7,4,136200,187200,51000,511
2,89,8,1,187200,222000,34800,666
2,89,10,4,222600,273600,51000,348
3,89,11,1,273600,308400,34800,666
3,89,13,4,309000,360000,51000,462
4,89,14,1,360000,367620,7620,666
4,89,16,1,368100,369900,1800,666
4,89,18,2,370500,390000,19500,537
4,89,20,4,390600,391500,900,491
4,89,22,3,391800,393780,1980,37
4,89,24,4,394380,395160,780,415
4,89,26,4,395700,397080,1380,543
4,89,28,4,397500,397980,480,522
4,89,30,1,398700,446400,47700,666
5,89,31,1,446400,464400,18000,666
5,89,33,4,465000,465300,300,568
5,89,35,4,466500,468900,2400,274
5,89,37,1,469500,532800,63300,666
6,89,38,7,532800,573300,40500,199
6,89,40,1,581100,583800,2700,666
6,89,42,4,584400,585000,600,404
6,89,44,1,585600,604800,19200,666
0,90,0,1,0,32400,32400,681
0,90,2,4,37500,37800,300,553
0,90,4,2,38400,38700,300,325
0,90,6,2,39300,40500,1200,325
0,90,8,2,41100,41400,300,325
0,90,10,1,42000,61200,19200,681
0,90,12,3,61800,62400,600,38
0,90,14,1,63000,75600,12600,681
0,90,16,1,81000,100800,19800,681
1,90,17,1,100800,116400,15600,681
1,90,19,2,117660,159060,41400,325
1,90,21,1,160200,187200,27000,681
2,90,22,1,187200,202800,15600,681
2,90,24,2,204060,245460,41400,325
2,90,26,1,246600,273600,27000,681
3,90,27,1,273600,289200,15600,681
3,90,29,2,290460,331860,41400,325
3,90,31,1,333000,360000,27000,681
4,90,32,1,360000,376200,16200,681
4,90,34,2,377820,389100,11280,325
4,90,36,4,389280,390480,1200,578
4,90,38,2,390600,406800,16200,325
4,90,40,3,409080,410520,1440,56
4,90,42,1,411900,446400,34500,681
5,90,43,1,446400,468480,22080,681
5,90,45,4,469200,470820,1620,627
5,90,47,3,471240,471540,300,78
5,90,49,1,471780,495120,23340,681
5,90,51,3,495360,495780,420,182
5,90,53,1,496020,500580,4560,681
5,90,55,4,501900,504300,2400,587
5,90,57,1,505740,532800,27060,681
6,90,58,1,532800,551400,18600,681
6,90,60,7,551700,565200,13500,127
6,90,62,1,565800,578700,12900,681
6,90,64,7,579300,587400,8100,127
6,90,66,1,588000,604800,16800,681
0,91,0,1,0,25800,25800,706
0,91,2,2,26580,59400,32820,568
0,91,4,3,60300,61800,1500,213
0,91,6,3,62580,63000,420,16
0,91,8,1,63600,100800,37200,706
1,91,9,1,100800,114900,14100,706
1,91,11,2,115140,137700,22560,568
1,91,13,1,138000,141240,3240,706
1,91,15,2,141420,147900,6480,568
1,91,17,1,148200,153420,5220,706
1,91,19,4,155100,164280,9180,598
1,91,21,1,165900,187200,21300,706
2,91,22,1,187200,201300,14100,706
2,91,24,2,201540,224100,22560,568
2,91,26,1,224400,227640,3240,706
2,91,28,2,227820,234300,6480,568
2,91,30,1,234600,239820,5220,706
2,91,32,4,241500,250680,9180,566
2,91,34,1,252300,273600,21300,706
3,91,35,1,273600,287700,14100,706
3,91,37,2,287940,310500,22560,568
3,91,39,1,310800,314040,3240,706
3,91,41,2,314220,320700,6480,568
3,91,43,1,321000,326220,5220,706
3,91,45,4,327900,337080,9180,561
3,91,47,1,338700,360000,21300,706
4,91,48,1,360000,367500,7500,706
4,91,50,2,368400,398700,30300,568
4,91,52,1,399900,446400,46500,706
5,91,53,1,446400,532800,86400,706
6,91,54,1,532800,544500,11700,706
6,91,56,2,546900,595800,48900,568
6,91,58,1,597600,604800,7200,706
0,92,0,1,0,36000,36000,722
0,92,2,4,36900,37800,900,631
0,92,4,4,38100,38400,300,387
0,92,6,2,39600,59400,19800,620
0,92,8,4,60000,63000,3000,308
0,92,10,4,65700,75600,9900,413
0,92,12,3,76500,76800,300,185
0,92,14,1,79200,100800,21600,722
1,92,15,1,100800,111480,10680,722
1,92,17,2,113760,127680,13920,620
1,92,19,4,128100,128760,660,618
1,92,21,4,129360,129780,420,417
1,92,23,2,130860,147720,16860,620
1,92,25,1,151380,187200,35820,722
2,92,26,1,187200,197880,10680,722
2,92,28,2,200160,214080,13920,620
2,92,30,4,214500,215160,660,396
2,92,32,4,215760,216180,420,587
2,92,34,2,217260,234120,16860,620
2,92,36,1,237780,273600,35820,722
3,92,37,1,273600,284280,10680,722
3,92,39,2,286560,300480,13920,620
3,92,41,4,300900,301560,660,618
3,92,43,4,302160,302580,420,455
3,92,45,2,303660,320520,16860,620
3,92,47,1,324180,360000,35820,722
4,92,48,1,360000,370800,10800,722
4,92,50,4,372600,373200,600,568
4,92,52,2,374400,378000,3600,620
4,92,54,4,379800,384300,4500,621
4,92,56,2,385200,392400,7200,620
4,92,58,1,392700,395400,2700,722
4,92,60,2,396000,406800,10800,620
4,92,62,1,407100,408570,1470,722
4,92,64,4,408690,419850,11160,284
4,92,66,1,419970,446400,26430,722
5,92,67,1,446400,473400,27000,722
5,92,69,4,475740,486000,10260,442
5,92,71,3,488670,488970,300,49
5,92,73,1,489780,532800,43020,722
6,92,74,1,532800,564000,31200,722
6,92,76,2,564180,564480,300,620
6,92,78,2,564840,565980,1140,620
6,92,80,3,566520,567360,840,79
6,92,82,3,567780,568260,480,233
6,92,84,3,568590,568890,300,2
6,92,86,1,569220,604800,35580,722
0,93,0,1,0,25200,25200,700
0,93,2,2,26100,45000,18900,540
0,93,4,4,45600,47700,2100,602
0,93,6,2,48600,61200,12600,540
0,93,8,1,62400,68400,6000,700
0,93,10,3,69300,76500,7200,213
0,93,12,1,77400,100800,23400,700
1,93,13,1,100800,114300,13500,700
1,93,15,2,122400,126300,3900,540
1,93,17,4,126900,130500,3600,609
1,93,19,3,138300,138660,360,231
1,93,21,1,139440,187200,47760,700
2,93,22,1,187200,200700,13500,700
2,93,24,2,208800,212700,3900,540
2,93,26,4,213300,216900,3600,591
2,93,28,3,224700,225060,360,38
2,93,30,1,225840,273600,47760,700
3,93,31,1,273600,287100,13500,700
3,93,33,2,295200,299100,3900,540
3,93,35,4,299700,303300,3600,332
3,93,37,3,311100,311460,360,68
3,93,39,1,312240,360000,47760,700
4,93,40,4,360000,446400,86400,383
5,93,41,1,446400,532800,86400,700
6,93,42,1,532800,550800,18000,700
6,93,44,3,552300,555300,3000,219
6,93,46,1,556800,559800,3000,700
6,93,48,4,565200,568800,3600,542
6,93,50,2,569400,571500,2100,540
6,93,52,4,572100,574200,2100,308
6,93,54,4,577800,586800,9000,587
6,93,56,3,588900,589500,600,213
6,93,58,1,591300,604800,13500,700
0,94,0,1,0,43800,43800,650
0,94,2,4,44040,45990,1950,343
0,94,4,1,46110,59580,13470,650
0,94,6,4,60000,60360,360,541
0,94,8,4,60780,61200,420,332
0,94,10,1,61560,62160,600,650
0,94,12,3,62520,64320,1800,40
0,94,14,1,64680,70620,5940,650
0,94,16,4,71040,72780,1740,572
0,94,18,1,73200,100800,27600,650
1,94,19,1,100800,108540,7740,650
1,94,21,4,108780,114240,5460,448
1,94,23,2,115320,152100,36780,309
1,94,25,1,153600,187200,33600,650
2,94,26,1,187200,194940,7740,650
2,94,28,4,195180,200640,5460,531
2,94,30,2,201720,238500,36780,309
2,94,32,1,240000,273600,33600,650
3,94,33,1,273600,281340,7740,650
3,94,35,4,281580,287040,5460,587
3,94,37,2,288120,324900,36780,309
3,94,39,1,326400,360000,33600,650
4,94,40,1,360000,369600,9600,650
4,94,42,2,370980,407400,36420,309
4,94,44,1,408540,446400,37860,650
5,94,45,1,446400,532800,86400,650
6,94,46,1,532800,562500,29700,650
6,94,48,4,563100,573300,10200,599
6,94,50,1,573900,604800,30900,650
0,95,0,1,0,29400,29400,728
0,95,2,2,30600,41280,10680,631
0,95,4,4,41700,44100,2400,507
0,95,6,2,44520,64800,20280,631
0,95,8,4,65700,68400,2700,620
0,95,10,4,69300,71100,1800,528
0,95,12,1,72000,74700,2700,728
0,95,14,4,75000,79800,4800,555
0,95,16,1,80220,100800,20580,728
1,95,17,1,100800,117300,16500,728
1,95,19,2,117600,128100,10500,631
1,95,21,1,128400,144120,15720,728
1,95,23,6,146700,157380,10680,260
1,95,25,1,159300,164220,4920,728
1,95,27,1,164700,168900,4200,728
1,95,29,1,169200,187200,18000,728
2,95,30,1,187200,203700,16500,728
2,95,32,2,204000,214500,10500,631
2,95,34,1,214800,230520,15720,728
2,95,36,6,233100,243780,10680,260
2,95,38,1,245700,250620,4920,728
2,95,40,1,251100,255300,4200,728
2,95,42,1,255600,273600,18000,728
3,95,43,1,273600,290100,16500,728
3,95,45,2,290400,300900,10500,631
3,95,47,1,301200,316920,15720,728
3,95,49,6,319500,330180,10680,260
3,95,51,1,332100,337020,4920,728
3,95,53,1,337500,341700,4200,728
3,95,55,1,342000,360000,18000,728
4,95,56,1,360000,446400,86400,728
5,95,57,1,446400,474360,27960,728
5,95,59,1,474480,482100,7620,728
5,95,61,4,482400,485400,3000,540
5,95,63,4,486000,491400,5400,389
5,95,65,1,492000,500400,8400,728
5,95,67,1,502080,532800,30720,728
6,95,68,1,532800,552660,19860,728
6,95,70,4,558300,565140,6840,325
6,95,72,1,567120,573780,6660,728
6,95,74,3,574440,580860,6420,175
6,95,76,1,581460,582420,960,728
6,95,78,4,583200,586560,3360,291
6,95,80,3,587040,587340,300,12
6,95,82,1,587640,604800,17160,728
0,96,0,1,0,74100,74100,701
0,96,2,1,76440,100800,24360,701
1,96,3,1,100800,113880,13080,701
1,96,5,2,114300,132300,18000,254
1,96,7,4,132900,134100,1200,569
1,96,9,2,134700,154380,19680,254
1,96,11,1,154800,187200,32400,701
2,96,12,1,187200,200280,13080,701
2,96,14,2,200700,218700,18000,254
2,96,16,4,219300,220500,1200,351
2,96,18,2,221100,240780,19680,254
2,96,20,1,241200,273600,32400,701
3,96,21,1,273600,286680,13080,701
3,96,23,2,287100,305100,18000,254
3,96,25,4,305700,306900,1200,438
3,96,27,2,307500,327180,19680,254
3,96,29,1,327600,360000,32400,701
4,96,30,1,360000,390000,30000,701
4,96,32,2,391800,425400,33600,254
4,96,34,4,425640,425940,300,446
4,96,36,1,427620,446400,18780,701
5,96,37,1,446400,477780,31380,701
5,96,39,4,478500,480480,1980,366
5,96,41,3,480780,483660,2880,141
5,96,43,1,484260,487800,3540,701
5,96,45,1,492300,494160,1860,701
5,96,47,4,494580,498600,4020,370
5,96,49,1,498960,532800,33840,701
6,96,50,1,532800,559200,26400,701
6,96,52,3,559800,561900,2100,42
6,96,54,1,562320,577800,15480,701
6,96,56,3,578400,579600,1200,99
6,96,58,1,580200,604800,24600,701
0,97,0,1,0,30000,30000,731
0,97,2,1,30300,59400,29100,731
0,97,4,1,59700,100800,41100,731
1,97,5,1,100800,115500,14700,731
1,97,7,4,115620,116100,480,572
1,97,9,2,116220,123300,7080,563
1,97,11,2,123600,127500,3900,563
1,97,13,2,128400,132000,3600,563
1,97,15,4,132300,132900,600,348
1,97,17,2,135720,141000,5280,563
1,97,19,2,142500,147600,5100,563
1,97,21,3,148080,148500,420,233
1,97,23,1,150900,187200,36300,731
2,97,24,1,187200,201900,14700,731
2,97,26,4,202020,202500,480,415
2,97,28,2,202620,209700,7080,563
2,97,30,2,210000,213900,3900,563
2,97,32,2,214800,218400,3600,563
2,97,34,4,218700,219300,600,618
2,97,36,2,222120,227400,5280,563
2,97,38,2,228900,234000,5100,563
2,97,40,3,234480,234900,420,226
2,97,42,1,237300,273600,36300,731
3,97,43,1,273600,288300,14700,731
3,97,45,4,288420,288900,480,568
3,97,47,2,289020,296100,7080,563
3,97,49,2,296400,300300,3900,563
3,97,51,2,301200,304800,3600,563
3,97,53,4,305100,305700,600,566
3,97,55,2,308520,313800,5280,563
3,97,57,2,315300,320400,5100,563
3,97,59,3,320880,321300,420,48
3,97,61,1,323700,360000,36300,731
4,97,62,1,360000,372900,12900,731
4,97,64,4,373800,374400,600,579
4,97,66,1,375300,388800,13500,731
4,97,68,2,389220,390000,780,563
4,97,70,4,390600,393600,3000,587
4,97,72,1,394200,400500,6300,731
4,97,74,4,401100,401700,600,355
4,97,76,4,402000,405000,3000,540
4,97,78,1,405600,446400,40800,731
5,97,79,1,446400,464400,18000,731
5,97,81,4,468000,480600,12600,553
5,97,83,1,486000,532800,46800,731
6,97,84,1,532800,559800,27000,731
6,97,86,1,562200,578700,16500,731
6,97,88,3,579300,580170,870,216
6,97,90,3,580290,581700,1410,78
6,97,92,4,582300,582900,600,308
6,97,94,1,583500,604800,21300,731
0,98,0,1,0,51000,51000,655
0,98,2,4,52140,55800,3660,404
0,98,4,3,56160,57600,1440,227
0,98,6,4,57900,67800,9900,587
0,98,8,1,69000,100800,31800,655
1,98,9,1,100800,137700,36900,655
1,98,11,4,139200,140100,900,567
1,98,13,3,141000,141600,600,50
1,98,15,1,142200,187200,45000,655
2,98,16,1,187200,224100,36900,655
2,98,18,4,225600,226500,900,623
2,98,20,3,227400,228000,600,130
2,98,22,1,228600,273600,45000,655
3,98,23,1,273600,310500,36900,655
3,98,25,4,312000,312900,900,334
3,98,27,3,313800,314400,600,117
3,98,29,1,315000,360000,45000,655
4,98,30,4,360000,446400,86400,374
5,98,31,1,446400,532800,86400,655
6,98,32,1,532800,560700,27900,655
6,98,34,3,563520,564240,720,103
6,98,36,3,565200,575100,9900,130
6,98,38,1,576000,581400,5400,655
6,98,40,2,582300,585600,3300,502
6,98,42,3,586500,589800,3300,124
6,98,44,1,592200,604800,12600,655
0,99,0,1,0,14400,14400,694
0,99,2,3,14520,36000,21480,11
0,99,4,3,37800,41400,3600,230
0,99,6,3,42000,46800,4800,152
0,99,8,1,49500,100800,51300,694
1,99,9,1,100800,117000,16200,694
1,99,13,1,154800,187200,32400,694
2,99,14,1,187200,203400,16200,694
2,99,18,1,241200,273600,32400,694
3,99,19,1,273600,289800,16200,694
3,99,23,1,327600,360000,32400,694
4,99,24,4,360000,446400,86400,371
5,99,25,1,446400,473400,27000,694
5,99,27,7,474300,486000,11700,104
5,99,29,1,486900,532800,45900,694
6,99,30,1,532800,570000,37200,694
6,99,32,4,572100,574680,2580,582
6,99,34,4,575100,577200,2100,352
6,99,36,3,577320,578100,780,207
6,99,38,3,579600,586200,6600,19
6,99,40,4,589260,592860,3600,314
6,99,42,1,595560,604800,9240,694
